station_name,full_price_tickets,reduced_price_tickets,season_tickets,total_entries_exits,interchanges,region,nlc_code,tlc_code
Abbey Wood,2318430,3470332,1329902,7118664,0,London,5131,ABW
Aber,77490,3548,22938,103976,0,Wales,3813,ABE
Abercynon,106686,3854,24340,134880,15581,Wales,3801,ACY
Aberdare,161382,10902,54430,226714,0,Wales,3982,ABA
Aberdeen,487274,1383410,90730,1961414,179272,Scotland,8976,ABD
Aberdour,28576,47162,3214,78952,0,Scotland,9090,AUR
Aberdovey,24642,9566,0,34208,0,Wales,4435,AVY
Abererch,1564,476,0,2040,0,Wales,4440,ABH
Abergavenny,169398,129348,60778,359524,0,Wales,3602,AGV
Abergele and Pensarn,41230,36848,3904,81982,0,Wales,2448,AGL
Aberystwyth,103522,136146,1898,241566,0,Wales,4303,AYW
Accrington,118656,284020,56940,459616,0,North West,2552,ACR
Achanalt,232,50,0,282,0,Scotland,8600,AAT
Achnasheen,1992,1246,64,3302,0,Scotland,8601,ACN
Achnashellach,430,322,0,752,0,Scotland,8602,ACH
Acklington,346,88,0,434,0,North East,7662,ACK
Acle,12910,24112,3650,40672,0,East of England,7286,ACL
Acocks Green,99164,127648,78094,304906,0,West Midlands,4529,ACG
Acton Bridge (Cheshire),17686,12724,2630,33040,0,North West,2287,ACB
Acton Central,514242,748324,236470,1499036,0,London,1404,ACC
Acton Main Line,340190,602452,157062,1099704,0,London,3000,AML
Adderley Park,59056,37140,23850,120046,0,West Midlands,1036,ADD
Addiewell,6648,6894,1024,14566,0,Scotland,9310,ADW
Addlestone,108918,111918,50848,271684,0,South East,5550,ASN
Adisham,6356,9290,7824,23470,0,South East,5160,ADM
Adlington (Cheshire),7118,10274,1390,18782,0,North West,2939,ADC
Adlington (Lancashire),30058,62794,12188,105040,0,North West,2641,ADL
Adwick,51206,51822,18176,121204,0,Yorkshire and The Humber,8353,AWK
Aigburth,135174,286910,144934,567018,0,North West,2255,AIG
Ainsdale,171718,580394,168514,920626,0,North West,2350,ANS
Aintree,189054,440238,212370,841662,0,North West,2125,AIN
Airbles,27468,40642,11390,79500,0,Scotland,9695,AIR
Airdrie,196716,341584,94498,632798,0,Scotland,9759,ADR
Albany Park,286128,253588,82774,622490,0,London,5132,AYP
Albrighton,27064,27812,14680,69556,0,West Midlands,4614,ALB
Alderley Edge,105456,77540,43696,226692,0,North West,2760,ALD
Aldermaston,12038,30466,8098,50602,0,South East,3145,AMT
Aldershot,346468,589196,157812,1093476,79583,South East,5623,AHT
Aldrington,44632,63252,19926,127810,0,South East,5280,AGT
Alexandra Palace,470546,709888,159616,1340050,43873,London,6025,AAP
Alexandra Parade,83590,165438,14686,263714,0,Scotland,9905,AXP
Alexandria,43810,78782,25748,148340,0,Scotland,9861,ALX
Alfreton,94974,184888,9976,289838,0,East Midlands,1805,ALF
Allens West,23140,34918,15108,73166,0,North East,7520,ALW
Alloa,90676,238920,25684,355280,0,Scotland,9883,ALO
Alness,13324,2718,762,16804,0,Scotland,8605,ASS
Alnmouth,15460,302826,12778,331064,263,North East,7787,ALM
Alresford (Essex),16418,26058,20974,63450,0,East of England,6847,ALR
Alsager,61616,26884,6122,94622,0,North West,1223,ASG
Althorne (Essex),8196,7992,5720,21908,0,East of England,6869,ALN
Althorpe,618,750,40,1408,0,Yorkshire and The Humber,6532,ALP
Altnabreac,262,18,0,280,0,Scotland,8606,ABC
Alton,152124,234996,108912,496032,0,South East,5544,AON
Altrincham,86220,104640,56654,247514,8,North West,2806,ALT
Alvechurch,54802,36662,32090,123554,0,West Midlands,1198,ALV
Ambergate,13910,17698,1554,33162,0,East Midlands,1678,AMB
Amberley,16632,33800,10148,60580,0,South East,5250,AMY
Amersham,632678,858442,72342,1563462,0,South East,506,AMR
Ammanford,7868,3122,20,11010,0,Wales,4236,AMF
Ancaster,4880,732,1936,7548,0,East Midlands,6358,ANC
Anderston,81606,95904,50996,228506,0,Scotland,9965,AND
Andover,171606,595142,154978,921726,16134,South East,5510,ADV
Anerley,319968,479538,101376,900882,0,London,5397,ANZ
Angmering,160312,385624,187906,733842,0,South East,5267,ANG
Annan,7296,91086,1016,99398,0,Scotland,9451,ANN
Anniesland,202336,451466,81646,735448,0,Scotland,9972,ANL
Ansdell and Fairhaven,8194,28756,4032,40982,0,North West,2662,AFV
Apperley Bridge,90146,217022,55820,362988,0,Yorkshire and The Humber,8562,APY
Appleby,7166,43222,2286,52674,0,North West,2052,APP
Appledore (Kent),6582,14642,5254,26478,0,South East,5003,APD
Appleford,3206,3032,996,7234,0,South East,3109,APF
Appley Bridge,38042,69272,23402,130716,0,North West,2396,APB
Apsley,153556,191356,60860,405772,0,East of England,1430,APS
Arbroath,107256,172076,13942,293274,14504,Scotland,9079,ARB
Ardgay,3604,778,30,4412,0,Scotland,8613,ARD
Ardlui,2492,790,0,3282,0,Scotland,9962,AUI
Ardrossan Harbour,50726,41358,338,92422,0,Scotland,9453,ADS
Ardrossan South Beach,41152,89844,12204,143200,284,Scotland,9569,ASB
Ardrossan Town,4008,9378,696,14082,0,Scotland,9455,ADN
Ardwick,212,112,0,324,0,North West,2960,ADK
Argyle Street,186068,543014,80832,809914,0,Scotland,9961,AGS
Arisaig,2298,1898,0,4196,0,Scotland,8821,ARG
Arlesey,192284,271504,88362,552150,0,East of England,6171,ARL
Armadale (West Lothian),68552,88818,15548,172918,0,Scotland,990,ARM
Armathwaite,976,6974,480,8430,0,North West,2054,AWT
Arnside,11754,77360,2216,91330,0,North West,1963,ARN
Arram,82,304,212,598,0,Yorkshire and The Humber,8045,ARR
Arrochar and Tarbet,12514,4054,390,16958,0,Scotland,9963,ART
Arundel,43840,152696,61858,258394,0,South East,5251,ARU
Ascot (Berks),312308,445200,63902,821410,224915,South East,5666,ACT
Ascott-Under-Wychwood,1154,136,338,1628,0,South East,3003,AUW
Ash,58968,108704,36378,204050,32638,South East,5641,ASH
Ash Vale,102848,141250,58960,303058,68635,South East,5547,AHV
Ashburys,32864,21416,11708,65988,0,North West,2941,ABY
Ashchurch for Tewkesbury,27158,48616,6056,81830,0,South West,4700,ASC
Ashfield,14786,35024,2250,52060,0,Scotland,9953,ASF
Ashford (Surrey),265398,270338,189232,724968,0,South East,5667,AFS
Ashford International,643488,1711392,892088,3246968,836593,South East,5004,AFK
Ashley,3050,2948,1904,7902,0,North West,2850,ASY
Ashtead,291202,375864,180318,847384,0,South East,5347,AHD
Ashton-Under-Lyne,65130,51320,25728,142178,0,North West,2790,AHN
Ashurst (Kent),9344,8178,8966,26488,0,South East,5398,AHS
Ashurst New Forest,18566,57742,15180,91488,0,South East,5906,ANF
Ashwell and Morden,44394,56834,39468,140696,0,East of England,6083,AWM
Askam,18472,32458,6676,57606,0,North West,1953,ASK
Aslockton,10260,9354,3858,23472,0,East Midlands,6233,ALK
Aspatria,8342,16590,2946,27878,0,North West,2095,ASP
Aspley Guise,1488,1946,1216,4650,0,East of England,1380,APG
Aston,230546,220590,104056,555192,19387,West Midlands,1004,AST
Atherstone,36884,56386,5420,98690,0,West Midlands,1074,ATH
Atherton,79802,73062,39998,192862,0,North West,2584,ATN
Attadale,776,234,32,1042,0,Scotland,8608,ATT
Attenborough,37988,10386,4330,52704,0,East Midlands,1624,ATB
Attleborough,63556,82966,22374,168896,0,East of England,7367,ATL
Auchinleck,17162,25948,1422,44532,0,Scotland,9457,AUK
Audley End,159338,313114,151118,623570,3349,East of England,7017,AUD
Aughton Park,33010,71086,35454,139550,0,North West,2215,AUG
Aviemore,43582,66878,1630,112090,69,Scotland,8610,AVM
Avoncliff,11520,10180,1702,23402,0,South West,3265,AVF
Avonmouth,83898,9560,16478,109936,0,South West,3200,AVN
Axminster,23054,236858,106538,366450,0,South West,5714,AXM
Aylesbury,330946,334144,208842,873932,3679,South East,1492,AYS
Aylesbury Vale Parkway,44188,38412,21144,103744,0,South East,1090,AVP
Aylesford,39442,32104,37646,109192,0,South East,5162,AYL
Aylesham,31870,41202,30054,103126,0,South East,5197,AYH
Ayr,278090,491884,51314,821288,52388,Scotland,9463,AYR
Bache,115732,215342,15848,346922,0,North West,2187,BAC
Baglan,15972,2504,6596,25072,0,Wales,4186,BAJ
Bagshot,40054,49796,14378,104228,0,South East,5681,BAG
Baildon,71930,49764,93048,214742,0,Yorkshire and The Humber,8552,BLD
Baillieston,39248,57962,20140,117350,0,Scotland,9763,BIO
Balcombe,48736,83260,31384,163380,0,South East,5492,BAB
Baldock,176544,249708,76334,502586,0,East of England,6084,BDK
Balham,1371102,1830622,974214,4175938,183785,London,5399,BAL
Balloch,95756,224686,30826,351268,0,Scotland,9862,BHC
Balmossie,570,96,168,834,0,Scotland,9013,BSI
Bamber Bridge,19234,38746,11188,69168,0,North West,2561,BMB
Bamford,13896,34772,602,49270,0,East Midlands,2820,BAM
Banavie,2102,2182,0,4284,0,Scotland,8839,BNV
Banbury,440808,1145532,227066,1813406,234856,South East,4502,BAN
Bangor (Gwynedd),164526,394588,18896,578010,502,Wales,2471,BNG
Bank Hall,37980,85818,87390,211188,0,North West,2238,BAH
Banstead,46962,53092,15418,115472,0,South East,5348,BAD
Barassie,36286,65094,10738,112118,0,Scotland,9466,BSS
Bardon Mill,2864,5396,10,8270,0,North East,7563,BLL
Bare Lane,17432,39826,55534,112792,0,North West,2690,BAR
Bargeddie,24344,41596,7268,73208,0,Scotland,9764,BGI
Bargoed,113848,6274,27970,148092,0,Wales,4011,BGD
Barking,3850930,6213612,2665670,12730212,746152,London,7492,BKG
Barking Riverside,174750,211744,74890,461384,0,London,1335,BGV
Barming,57864,116374,30708,204946,0,South East,5133,BMG
Barmouth,100876,39022,30460,170358,0,Wales,4445,BRM
Barnehurst,322854,361682,156496,841032,0,London,5089,BNH
Barnes,671828,824192,409180,1905200,17391,London,5551,BNS
Barnes Bridge,257144,313590,113844,684578,0,London,5580,BNI
Barnetby,4916,34762,2784,42462,3862,Yorkshire and The Humber,6406,BTB
Barnham,190052,340756,393744,924552,702656,South East,5252,BAA
Barnhill,18242,30734,5518,54494,0,Scotland,9973,BNL
Barnsley,424502,613256,175576,1213334,22708,Yorkshire and The Humber,6774,BNY
Barnstaple,75328,306956,154656,536940,0,South West,5725,BNP
Barnt Green,86114,69626,90756,246496,48878,West Midlands,1096,BTG
Barrhead,140358,211320,85602,437280,0,Scotland,9674,BRR
Barrhill,1690,3334,0,5024,0,Scotland,9467,BRL
Barrow Haven,170,308,0,478,0,Yorkshire and The Humber,6212,BAV
Barrow-In-Furness,105920,386520,47292,539732,26332,North West,1954,BIF
Barrow-Upon-Soar,34950,26386,14380,75716,0,East Midlands,1903,BWS
Barry,336604,28412,87008,452024,3450,Wales,3805,BRY
Barry Docks,163952,9572,46268,219792,0,Wales,3806,BYD
Barry Island,257536,24858,85200,367594,0,Wales,3807,BYI
Barry Links,456,14,0,470,0,Scotland,9020,BYL
Barton-On-Humber,8646,14996,654,24296,0,Yorkshire and The Humber,6207,BAU
Basildon,1012610,761742,619808,2394160,0,East of England,7494,BSO
Basingstoke,953180,2411440,639446,4004066,1076621,South East,5520,BSK
Bat and Ball,58060,49044,63628,170732,0,South East,5090,BBL
Bath Spa,937716,4260936,269814,5468466,173415,South West,3271,BTH
Bathgate,282916,407492,79122,769530,0,Scotland,9311,BHG
Batley,118146,103610,43132,264888,0,Yorkshire and The Humber,8484,BTL
Battersby,268,1676,220,2164,0,Yorkshire and The Humber,7909,BTT
Battersea Park,423854,609134,340806,1373794,4479,London,5420,BAK
Battle,77294,223788,99732,400814,0,South East,5215,BAT
Battlesbridge,6768,6700,5618,19086,0,East of England,6870,BLB
Bayford,21184,29704,4888,55776,0,East of England,6006,BAY
Beaconsfield,400826,384088,179992,964906,0,South East,3047,BCF
Bearley,748,600,32,1380,0,West Midlands,2420,BER
Bearsden,103440,172922,31068,307430,0,Scotland,9966,BRN
Bearsted,58250,118112,85388,261750,0,South East,5091,BSD
Beasdale,90,80,0,170,0,Scotland,8822,BSL
Beaulieu Road,1536,12996,914,15446,0,South East,5890,BEU
Beauly,29264,5074,2250,36588,0,Scotland,8877,BEL
Bebington,324922,329066,95586,749574,0,North West,2188,BEB
Beccles,30464,76608,4742,111814,0,East of England,7258,BCC
Beckenham Hill,113866,149236,48408,311510,0,London,5076,BEC
Beckenham Junction,503644,713604,234190,1451438,35852,London,5046,BKJ
Bedford,452230,2013408,570074,3035712,40131,East of England,1512,BDM
Bedford St Johns,21092,93906,26588,141586,0,East of England,1510,BSJ
Bedhampton,29174,47878,12980,90032,0,South East,5538,BDH
Bedminster,48562,46968,7716,103246,0,South West,3245,BMT
Bedworth,32018,16154,6364,54536,0,West Midlands,1165,BEH
Bedwyn,10548,57710,13276,81534,0,South West,3070,BDW
Beeston,220246,191510,27654,439410,38454,East Midlands,1625,BEE
Bekesbourne,10050,9366,3454,22870,0,South East,5198,BKS
Belle Vue,2822,2514,1208,6544,0,North West,2785,BLV
Bellgrove,173078,333678,47290,554046,15751,Scotland,9895,BLG
Bellingham,198724,209274,144156,552154,0,London,5062,BGM
Bellshill,160708,248068,102468,511244,31838,Scotland,9714,BLH
Belmont,53112,51540,39884,144536,0,London,5350,BLM
Belper,49656,111904,6930,168490,1672,East Midlands,1679,BLP
Beltring,4816,4178,3232,12226,0,South East,5227,BEG
Belvedere,279388,377904,141762,799054,0,London,5092,BVD
Bempton,2982,17230,886,21098,0,Yorkshire and The Humber,8047,BEM
Ben Rhydding,86022,60154,37606,183782,0,Yorkshire and The Humber,8564,BEY
Benfleet,1040696,719776,637588,2398060,0,East of England,7439,BEF
Bentham,5754,29536,1126,36416,0,Yorkshire and The Humber,2676,BEN
Bentley (Hampshire),34062,30634,17790,82486,0,South East,5624,BTY
Bentley (South Yorkshire),38108,54214,20380,112702,0,Yorkshire and The Humber,8352,BYK
Bere Alston,5978,19420,5692,31090,0,South West,3549,BAS
Bere Ferrers,912,7848,2498,11258,0,South West,3550,BFE
Berkhamsted,391396,507068,124902,1023366,0,East of England,1390,BKM
Berkswell,55380,94394,72434,222208,0,West Midlands,1045,BKW
Bermuda Park,12946,6830,2166,21942,0,West Midlands,6543,BEP
Berney Arms,504,438,8,950,0,East of England,7330,BYA
Berry Brow,8578,8634,7990,25202,0,Yorkshire and The Humber,8431,BBW
Berrylands,113414,144352,30450,288216,0,London,5581,BRS
Berwick (Sussex),14316,38582,18270,71168,0,South East,5323,BRK
Berwick-Upon-Tweed,0,555546,12236,567782,6581,North East,7791,BWK
Bescar Lane,1030,1112,48,2190,0,North West,2351,BES
Bescot Stadium,39594,64042,30558,134194,0,West Midlands,1003,BSC
Betchworth,3880,6040,2448,12368,0,South East,5472,BTO
Bethnal Green,430254,687088,213570,1330912,0,London,6961,BET
Betws-y-Coed,19400,13846,76,33322,0,Wales,2449,BYC
Beverley,73820,447566,82248,603634,6,Yorkshire and The Humber,8048,BEV
Bexhill,262672,555122,581786,1399580,0,South East,5211,BEX
Bexley,392952,431884,129660,954496,0,London,5093,BXY
Bexleyheath,584484,640464,198478,1423426,0,London,5094,BXH
Bicester North,141212,404400,86932,632544,18563,South East,3048,BCS
Bicester Village,186156,1286918,137522,1610596,616,South East,3104,BIT
Bickley,237026,261496,79646,578168,3410,London,5063,BKL
Bidston,95472,114516,60886,270874,76964,North West,2136,BID
Biggleswade,254916,379590,118544,753050,0,East of England,6170,BIW
Bilbrook,59624,23560,19152,102336,0,West Midlands,4618,BBK
Billericay,809220,574122,503672,1887014,0,East of England,6871,BIC
Billingham,22232,48096,6906,77234,0,North East,7910,BIL
Billingshurst,96102,186814,107956,390872,0,South East,5464,BIG
Bingham,21058,34642,7840,63540,0,East Midlands,6235,BIN
Bingley,279864,462642,177494,920000,0,Yorkshire and The Humber,8553,BIY
Birchgrove,26328,1526,5524,33378,0,Wales,3907,BCG
Birchington-On-Sea,35780,96022,176044,307846,0,South East,5163,BCH
Birchwood,168640,138808,51308,358756,0,North West,2304,BWD
Birkbeck,34918,25604,10722,71244,0,London,5401,BIK
Birkdale,153768,666114,154632,974514,0,North West,2352,BDL
Birkenhead Central,241100,271034,115060,627194,0,North West,2217,BKC
Birkenhead Hamilton Square,696478,405278,193002,1294758,329065,North West,2219,BKQ
Birkenhead North,464062,269390,145026,878478,71783,North West,2145,BKN
Birkenhead Park,264098,218144,114218,596460,0,North West,2220,BKP
Birmingham International,1244620,2501644,438826,4185090,258069,West Midlands,1215,BHI
Birmingham Moor Street,1635602,2527772,1362402,5525776,335256,West Midlands,4515,BMO
Birmingham New Street,8122474,16961660,5642146,30726280,4328228,West Midlands,1127,BHM
Birmingham Snow Hill,727288,1078192,912838,2718318,175501,West Midlands,1006,BSW
Bishop Auckland,33046,103540,16978,153564,0,North East,7835,BIA
Bishopbriggs,151044,356498,36048,543590,0,Scotland,9940,BBG
Bishops Lydeard,0,0,0,0,0,South West,3446,BIB
Bishops Stortford,783968,978128,601384,2363480,71988,East of England,6800,BIS
Bishopstone (Sussex),11648,28248,3208,43104,0,South East,5402,BIP
Bishopton (Renfrewshire),155020,299080,97466,551566,0,Scotland,9620,BPT
Bitterne,21006,35198,9094,65298,0,South East,5945,BTE
Blackburn,250204,821990,129510,1201704,71203,North West,2737,BBN
Blackheath,690438,1083700,295530,2069668,4047,London,5095,BKH
Blackhorse Road,568902,945460,418100,1932462,0,London,7400,BHO
Blackpool North,175268,1691274,42236,1908778,987,North West,2739,BPN
Blackpool Pleasure Beach,11906,120126,1050,133082,0,North West,2738,BPB
Blackpool South,13616,84606,6342,104564,0,North West,2740,BPS
Blackridge,15778,18682,2822,37282,0,Scotland,991,BKR
Blackrod,37076,42952,74216,154244,0,North West,2732,BLK
Blackwater,87324,197252,36362,320938,0,South East,5625,BAW
Blaenau Ffestiniog,12872,16910,28,29810,0,Wales,2450,BFF
Blair Atholl,4978,8384,40,13402,0,Scotland,8750,BLA
Blairhill,90244,154020,45900,290164,0,Scotland,9760,BAI
Blake Street,72170,92716,99366,264252,0,West Midlands,1176,BKT
Blakedown,15918,9512,47542,72972,0,West Midlands,4574,BKD
Blantyre,99954,168076,44218,312248,0,Scotland,9716,BLT
Blaydon,8306,26602,9250,44158,0,North East,7503,BLO
Bleasby,4550,716,18,5284,0,East Midlands,6204,BSB
Bletchley,136414,414180,183616,734210,58278,South East,1360,BLY
Bloxwich,33446,40254,1346,75046,0,West Midlands,1141,BLX
Bloxwich North,35322,40868,1580,77770,0,West Midlands,1018,BWN
Blundellsands and Crosby,285914,822824,256270,1365008,0,North West,2123,BLN
Blythe Bridge,39266,24146,8888,72300,0,West Midlands,1282,BYB
Bodmin Parkway,7200,238908,15308,261416,0,South West,3501,BOD
Bodorgan,2514,2350,92,4956,0,Wales,2435,BOR
Bognor Regis,194264,578096,252664,1025024,0,South East,5253,BOG
Bogston,6460,10302,2708,19470,0,Scotland,9668,BGS
Bolton,676932,1434132,388258,2499322,422583,North West,2599,BON
Bolton-Upon-Dearne,28700,19938,14798,63436,0,Yorkshire and The Humber,8536,BTD
Bond Street,5507506,11466274,2426636,19400416,0,London,6553,BDS
Bookham,70190,75158,22706,168054,0,South East,5626,BKA
Bootle (Cumbria),3660,7458,848,11966,0,North West,1993,BOC
Bootle New Strand,196850,401382,149260,747492,1254,North West,2195,BNW
Bootle Oriel Road,153814,313632,116628,584074,0,North West,2239,BOT
Bordesley,916,7474,698,9088,0,West Midlands,4513,BBS
Borough Green and Wrotham,110566,116150,80234,306950,0,South East,5130,BRG
Borth,32372,12022,508,44902,0,Wales,4304,BRH
Bosham,20544,27564,11096,59204,0,South East,5254,BOH
Boston,63234,129756,7102,200092,1,East Midlands,6216,BSN
Botley,30954,72650,21840,125444,0,South East,5894,BOE
Bottesford,25128,17350,6030,48508,0,East Midlands,6237,BTF
Bourne End,64376,80288,49394,194058,84287,South East,3018,BNE
Bournemouth,433204,1895664,101256,2430124,48487,South West,5876,BMH
Bournville,213822,318930,169626,702378,0,West Midlands,1112,BRV
Bow Brickhill,4440,4206,9886,18532,0,South East,1381,BWB
Bow Street,14764,7246,1272,23282,0,Wales,4219,BOW
Bowes Park,165552,158202,79198,402952,0,London,6027,BOP
Bowling,6410,12310,6714,25434,0,Scotland,9968,BWG
Box Hill and Westhumble,23830,76136,5982,105948,0,South East,5403,BXW
Bracknell,515106,771352,204210,1490668,132,South East,5693,BCE
Bradford Forster Square,510654,585840,341238,1437732,27880,Yorkshire and The Humber,8346,BDQ
Bradford Interchange,566596,1311412,346904,2224912,69528,Yorkshire and The Humber,8345,BDI
Bradford-On-Avon,180694,215466,30540,426700,6234,South West,3341,BOA
Brading,3298,10506,2574,16378,0,South East,5530,BDN
Braintree,115572,228136,181074,524782,0,East of England,6801,BTR
Braintree Freeport,31828,58314,19164,109306,0,East of England,2053,BTP
Bramhall,56760,66854,25694,149308,0,North West,2944,BML
Bramley (Hampshire),52280,129526,37714,219520,0,South East,5500,BMY
Bramley (West Yorkshire),115462,93030,49710,258202,0,Yorkshire and The Humber,8496,BLE
Brampton (Cumbria),3572,6342,46,9960,0,North West,7565,BMP
Brampton (Suffolk),2808,5656,926,9390,0,East of England,7259,BRP
Branchton,29730,45600,13176,88506,0,Scotland,9938,BCN
Brandon,48198,56440,10464,115102,0,East of England,7200,BND
Branksome,51658,138034,12772,202464,0,South West,5875,BSM
Braystones,194,1088,0,1282,0,North West,2045,BYS
Bredbury,64914,57046,34486,156446,0,North West,2779,BDY
Breich,2506,1926,52,4484,0,Scotland,9251,BRC
Brentford,340906,339980,216792,897678,0,London,5552,BFD
Brentwood,1176284,1336510,336818,2849612,0,East of England,6872,BRE
Bricket Wood,10140,8670,2898,21708,0,East of England,1560,BWO
Bridge Of Allan,96294,87668,8598,192560,0,Scotland,9889,BEA
Bridge Of Orchy,3546,1844,0,5390,0,Scotland,8823,BRO
Bridgend,619720,368602,144962,1133284,33063,Wales,3809,BGN
Bridgeton,142390,291170,66748,500308,0,Scotland,9789,BDG
Bridgwater,121014,283818,23896,428728,0,South West,3449,BWT
Bridlington,62942,407906,33940,504788,1082,Yorkshire and The Humber,8049,BDT
Brierfield,8684,15436,5290,29410,0,North West,2554,BRF
Brigg,48,240,0,288,0,Yorkshire and The Humber,6464,BGG
Brighouse,98976,194644,36162,329782,0,Yorkshire and The Humber,8514,BGH
Brighton,2580238,9925494,1547158,14052890,893229,South East,5268,BTN
Brimsdown,325696,472108,139768,937572,0,London,6810,BMD
Brinnington,31264,31170,19638,82072,0,North West,2603,BNT
Bristol Parkway,318880,1445160,59606,1823646,677864,South West,3230,BPW
Bristol Temple Meads,2268610,6603686,419384,9291680,1242101,South West,3231,BRI
Brithdir,9144,428,2798,12370,0,Wales,4012,BHD
Briton Ferry,20684,2772,1966,25422,0,Wales,4187,BNF
Brixton,236716,328280,139164,704160,0,London,5081,BRX
Broad Green,160568,122828,84156,367552,0,North West,2240,BGE
Broadbottom,44772,34416,23656,102844,0,North West,2892,BDB
Broadstairs,94950,442736,93722,631408,0,South East,5006,BSR
Brockenhurst,173986,501120,124026,799132,196256,South East,5886,BCU
Brockholes,14804,16940,3006,34750,0,Yorkshire and The Humber,8429,BHS
Brockley,1037520,1903728,389662,3330910,0,London,5404,BCY
Bromborough,207200,214098,105252,526550,0,North West,2190,BOM
Bromborough Rake,69286,95118,49080,213484,0,North West,2191,BMR
Bromley Cross (Lancs),90432,92266,56316,239014,0,North West,2697,BMC
Bromley North,66136,76374,37386,179896,0,London,5096,BMN
Bromley South,1751032,2892144,900120,5543296,764420,London,5064,BMS
Bromsgrove,239990,174706,98478,513174,0,West Midlands,4715,BMV
Brondesbury,597922,1079880,500916,2178718,0,London,1437,BSY
Brondesbury Park,319928,436002,137646,893576,0,London,1438,BSP
Brookmans Park,100850,99688,19008,219546,0,East of England,6074,BPK
Brookwood,322252,261576,139558,723386,45458,South East,5687,BKO
Broome,518,104,0,622,0,West Midlands,4175,BME
Broomfleet,222,506,62,790,0,Yorkshire and The Humber,8050,BMF
Brora,3448,1146,0,4594,0,Scotland,8618,BRA
Brough,37836,361726,17750,417312,7623,Yorkshire and The Humber,8051,BUH
Broughty Ferry,56718,24488,3062,84268,0,Scotland,9023,BYF
Broxbourne,546050,693902,136298,1376250,284657,East of England,6812,BXB
Bruce Grove,301468,521288,176392,999148,0,London,6958,BCV
Brundall,32826,50410,8832,92068,958,East of England,7289,BDA
Brundall Gardens,6498,6966,1094,14558,0,East of England,7006,BGA
Brunstane,62194,45172,2578,109944,0,Scotland,8807,BSU
Brunswick,279646,288996,214056,782698,0,North West,3623,BRW
Bruton,17766,27658,814,46238,0,South West,5702,BRU
Bryn,34966,42050,6470,83486,0,North West,2222,BYN
Buckenham,46,208,100,354,0,East of England,7290,BUC
Buckley,27960,2036,332,30328,0,Wales,2422,BCK
Bucknell,1596,590,858,3044,0,West Midlands,4182,BUK
Buckshaw Parkway,103990,186848,49418,340256,0,North West,7501,BSV
Bugle,628,5416,576,6620,0,South West,3502,BGL
Builth Road,2082,1744,88,3914,0,Wales,4317,BHR
Bulwell,30646,13996,11694,56336,0,East Midlands,1865,BLW
Bures,16218,16822,12028,45068,0,East of England,7085,BUE
Burgess Hill,308680,753302,405110,1467092,0,South East,5483,BUG
Burley Park,176898,346888,45234,569020,0,Yorkshire and The Humber,8500,BUY
Burley-In-Wharfedale,168600,122454,174192,465246,0,Yorkshire and The Humber,8565,BUW
Burnage,57482,61854,22852,142188,0,North West,2945,BNA
Burneside (Cumbria),2542,12358,2018,16918,0,North West,1975,BUD
Burnham (Buckinghamshire),410526,587466,259840,1257832,0,South East,3176,BNM
Burnham-On-Crouch,58444,62700,41826,162970,0,East of England,6873,BUU
Burnley Barracks,8218,15248,2438,25904,0,North West,2743,BUB
Burnley Central,29640,50228,20314,100182,7,North West,2550,BNC
Burnley Manchester Road,156962,311664,38738,507364,7748,North West,2549,BYM
Burnside (South Lanarkshire),49354,117234,15638,182226,0,Scotland,9767,BUI
Burntisland,53250,85592,11820,150662,0,Scotland,9107,BTS
Burscough Bridge,62458,77292,25548,165298,0,North West,2279,BCB
Burscough Junction,19104,18134,3032,40270,0,North West,2280,BCJ
Bursledon,15514,33452,5784,54750,0,South East,5927,BUO
Burton Joyce,5934,3264,228,9426,0,East Midlands,6200,BUJ
Burton-On-Trent,193310,439098,31090,663498,12749,West Midlands,1658,BUT
Bury St Edmunds,235218,390422,72642,698282,911,East of England,7008,BSE
Busby,35006,61588,8498,105092,0,Scotland,9791,BUS
Bush Hill Park,372088,462150,59440,893678,0,London,6913,BHK
Bushey,397220,543664,59964,1000848,0,East of England,1395,BSH
Butlers Lane,35298,56550,50220,142068,0,West Midlands,1179,BUL
Buxted,29048,39872,23936,92856,0,South East,5324,BXD
Buxton,36816,230932,33820,301568,0,East Midlands,2946,BUX
Byfleet and New Haw,134794,128594,53412,316800,0,South East,5689,BFN
Bynea,878,388,0,1266,0,Wales,4124,BYE
Cadoxton,201510,9542,47112,258164,0,Wales,3811,CAD
Caergwrle,8290,846,730,9866,0,Wales,2536,CGW
Caerphilly,407356,29334,88210,524900,0,Wales,3812,CPH
Caersws,19592,21184,1724,42500,0,Wales,4412,CWS
Caldercruix,23120,31170,12904,67194,0,Scotland,992,CAC
Caldicot,51508,7126,7278,65912,0,Wales,3680,CDT
Caledonian Road and Barnsbury,453940,658682,215820,1328442,0,London,1439,CIR
Calstock,2008,26094,3514,31616,0,South West,3562,CSK
Cam and Dursley,65684,109712,7580,182976,0,South West,3238,CDU
Camberley,96216,173028,18656,287900,0,South East,5682,CAM
Camborne,30310,206272,59226,295808,0,South West,3504,CBN
Cambridge,2331900,5809382,1200318,9341600,481342,East of England,7022,CBG
Cambridge Heath,242406,407088,121996,771490,0,London,6962,CBH
Cambridge North,341708,635710,97184,1074602,936,East of England,8001,CMB
Cambuslang,199304,342460,87514,629278,31582,Scotland,9768,CBL
Camden Road,1172670,1959568,592436,3724674,11725,London,1440,CMD
Camelon,55600,55750,13522,124872,0,Scotland,9878,CMO
Canada Water,4676574,9054286,2495230,16226090,914,London,1659,ZCW
Canary Wharf,3220892,5461406,1242308,9924606,0,London,6560,CWX
Canley,99356,181554,82886,363796,0,West Midlands,1129,CNL
Cannock,86312,133628,13350,233290,0,West Midlands,1016,CAO
Canonbury,741898,1359576,248210,2349684,841885,London,1441,CNN
Canterbury East,209982,593110,132536,935628,9490,South East,5164,CBE
Canterbury West,488644,1380204,308420,2177268,146230,South East,5007,CBW
Cantley,4634,7510,3596,15740,0,East of England,7292,CNY
Capenhurst,67322,84892,18514,170728,0,North West,2186,CPU
Carbis Bay,0,226200,568,226768,0,South West,3542,CBB
Cardenden,13526,16800,1324,31650,0,Scotland,9112,CDD
Cardiff Bay,374458,40950,95556,510964,0,Wales,3815,CDB
Cardiff Central,5429162,3814512,941348,10185022,1132335,Wales,3899,CDF
Cardiff Queen Street,1375824,86438,251458,1713720,395420,Wales,3900,CDQ
Cardonald,56132,98754,26932,181818,0,Scotland,9624,CDO
Cardross,24116,46878,55254,126248,0,Scotland,9969,CDR
Carfin,28352,47264,11604,87220,0,Scotland,9877,CRF
Cark and Cartmel,16920,61350,5974,84244,0,North West,1964,CAK
Carlisle,90582,1607678,102938,1801198,301547,North West,2118,CAR
Carlton,16706,16276,3864,36846,0,East Midlands,6201,CTO
Carluke,86938,118336,25496,230770,0,Scotland,9702,CLU
Carmarthen,160334,114620,17652,292606,9634,Wales,4068,CMN
Carmyle,28354,51448,12644,92446,0,Scotland,9769,CML
Carnforth,24468,107334,30598,162400,15713,North West,2640,CNF
Carnoustie,53466,42864,3754,100084,0,Scotland,9028,CAN
Carntyne,83206,148270,23054,254530,0,Scotland,9897,CAY
Carpenders Park,279874,635126,59748,974748,0,East of England,1442,CPK
Carrbridge,3098,1742,0,4840,0,Scotland,8621,CAG
Carshalton,396536,503250,159550,1059336,0,London,5405,CSH
Carshalton Beeches,262772,291960,71664,626396,0,London,5406,CSB
Carstairs,8292,4586,628,13506,7067,Scotland,9704,CRS
Cartsdyke,21562,40416,13544,75522,0,Scotland,9680,CDY
Castle Bar Park,30360,30664,5646,66670,0,London,3098,CBP
Castle Cary,6894,301942,2978,311814,37749,South West,5703,CLC
Castleford,202048,144044,64364,410456,7980,Yorkshire and The Humber,8359,CFD
Castleton (Manchester),41128,38684,16154,95966,0,North West,2919,CAS
Castleton Moor,822,3480,492,4794,0,Yorkshire and The Humber,7914,CSM
Caterham,212922,240146,118760,571828,0,South East,5351,CAT
Catford,264722,261900,160240,686862,142144,London,5077,CTF
Catford Bridge,578532,872766,382008,1833306,53974,London,5047,CFB
Cathays,524710,76650,97552,698912,0,Wales,3820,CYS
Cathcart,100162,223264,45656,369082,643,Scotland,9795,CCT
Cattal,14604,40488,9354,64446,0,Yorkshire and The Humber,8232,CTL
Causeland,138,1450,0,1588,0,South West,3568,CAU
Cefn-Y-Bedd,4948,522,162,5632,0,Wales,2425,CYB
Chadwell Heath,1575180,2388878,536040,4500098,0,London,6874,CTH
Chafford Hundred Lakeside,776222,996586,355162,2127970,0,East of England,7447,CFH
Chalfont and Latimer,287036,409546,12774,709356,0,South East,539,CFO
Chalkwell,538456,326776,317464,1182696,0,East of England,7469,CHW
Chandlers Ford,39188,72510,17108,128806,0,South East,5836,CFR
Chapel-En-Le-Frith,13454,41956,9308,64718,0,East Midlands,2762,CEF
Chapelton (Devon),110,76,8,194,0,South West,5820,CPN
Chapeltown (South Yorkshire),147374,81748,54054,283176,0,Yorkshire and The Humber,6664,CLN
Chappel and Wakes Colne,7182,14690,6304,28176,0,East of England,7051,CWC
Charing (Kent),24226,29890,21472,75588,0,South East,5097,CHG
Charing Cross (Glasgow),406148,707030,196828,1310006,0,Scotland,9911,CHC
Charlbury,56194,182174,18982,257350,0,South East,3004,CBY
Charlton,361020,584994,223372,1169386,50945,London,5144,CTN
Chartham,28114,33726,17974,79814,0,South East,5008,CRT
Chassen Road,17736,4406,10688,32830,0,North West,2947,CSR
Chatelherault,15724,29834,16354,61912,0,Scotland,9707,CTE
Chatham,598184,870308,541836,2010328,6950,South East,5199,CTM
Chathill,1064,264,20,1348,0,North East,7792,CHT
Cheadle Hulme,239606,215138,108912,563656,6267,North West,2870,CHU
Cheam,322732,343444,124186,790362,0,London,5352,CHE
Cheddington,17766,23904,6344,48014,0,South East,1372,CED
Chelford (Cheshire),17538,17426,5022,39986,0,North West,2764,CEL
Chelmsford,2229958,2065034,1489592,5784584,43397,East of England,6836,CHM
Chelsfield,252746,125020,100466,478232,0,London,5098,CLD
Cheltenham Spa,438688,1453782,72782,1965252,221843,South West,4731,CNM
Chepstow,101694,60608,16972,179274,0,Wales,3774,CPW
Cherry Tree,7788,18868,5956,32612,0,North West,2573,CYT
Chertsey,150586,123096,277466,551148,0,South East,5553,CHY
Cheshunt,782896,1193460,149370,2125726,231588,East of England,6814,CHN
Chessington North,145352,167188,64140,376680,0,London,5582,CSN
Chessington South,118364,109540,47402,275306,0,London,5554,CSS
Chester,1300792,2650564,170236,4121592,688851,North West,2412,CTR
Chester Road,161434,215390,112258,489082,0,West Midlands,1130,CRD
Chesterfield,224944,1160114,64962,1450020,164810,East Midlands,6615,CHD
Chester-Le-Street,14508,92054,11524,118086,0,North East,7736,CLS
Chestfield and Swalecliffe,20564,31910,27958,80432,0,South East,5200,CSW
Chetnole,708,1340,0,2048,0,South West,5840,CNO
Chichester,652686,1251822,530076,2434584,40719,South East,5255,CCH
Chilham,10412,24008,13880,48300,0,South East,5009,CIL
Chilworth,8802,11384,3526,23712,0,South East,5296,CHL
Chingford,620392,975842,99214,1695448,0,London,6914,CHI
Chinley,39006,42620,11618,93244,1356,East Midlands,2823,CLY
Chippenham,270908,1036244,137722,1444874,26946,South West,3267,CPM
Chipstead,34918,35810,10122,80850,0,South East,5353,CHP
Chirk,42122,28676,2204,73002,0,Wales,4449,CRK
Chislehurst,375852,402486,85954,864292,0,London,5099,CIT
Chiswick,215156,274156,100006,589318,0,London,5583,CHK
Cholsey,48868,117984,45546,212398,0,South East,3031,CHO
Chorley,112578,374724,72834,560136,0,North West,2745,CRL
Chorleywood,186714,257424,11258,455396,0,East of England,546,CLW
Christchurch,103302,265886,31372,400560,0,South West,5879,CHR
Christs Hospital,30726,63942,25054,119722,0,South East,5319,CHH
Church and Oswaldtwistle,12616,23092,9814,45522,0,North West,2556,CTW
Church Fenton,24574,67686,24458,116718,9705,Yorkshire and The Humber,8233,CHF
Church Stretton,60992,33560,16084,110636,0,West Midlands,4365,CTT
Cilmeri,328,432,0,760,0,Wales,3785,CIM
City Thameslink,3174524,2339446,925444,6439414,1984,London,5121,CTK
Clacton-on-Sea,133518,421448,150950,705916,0,East of England,6850,CLT
Clandon,49676,51728,17700,119104,0,South East,5555,CLA
Clapham (North Yorkshire),2210,6740,190,9140,0,Yorkshire and The Humber,2653,CPY
Clapham High Street,461570,653798,271606,1386974,0,London,5301,CLP
Clapham Junction,6535950,10262910,3991290,20790150,19090976,London,5595,CLJ
Clapton,537286,918016,234848,1690150,3,London,6926,CPT
Clarbeston Road,3246,2576,544,6366,0,Wales,4069,CLR
Clarkston,98942,187954,23516,310412,0,Scotland,9792,CKS
Claverdon,1402,982,788,3172,0,West Midlands,4593,CLV
Claygate,158232,147894,104674,410800,0,South East,5556,CLG
Cleethorpes,19486,171622,3538,194646,0,Yorkshire and The Humber,6274,CLE
Cleland,31686,45140,11942,88768,0,Scotland,9718,CEA
Clifton (Manchester),180,12,16,208,0,North West,2795,CLI
Clifton Down,416130,95198,97312,608640,0,South West,3202,CFN
Clitheroe,57306,169200,60664,287170,0,North West,2574,CLH
Clock House,313200,369388,95734,778322,1896,London,5048,CLK
Clunderwen,7852,8670,0,16522,0,Wales,4070,CUW
Clydebank,66616,109534,42700,218850,0,Scotland,9855,CYK
Coatbridge Central,13766,16494,3842,34102,0,Scotland,9747,CBC
Coatbridge Sunnyside,119744,196536,42670,358950,0,Scotland,9752,CBS
Coatdyke,67978,83764,31890,183632,0,Scotland,9762,COA
Cobham and Stoke D'abernon,155094,176480,57888,389462,0,South East,5557,CSD
Codsall,40426,43898,22016,106340,0,West Midlands,4616,CSL
Cogan,195172,10022,37444,242638,0,Wales,3828,CGN
Colchester,605816,1837228,949698,3392742,450695,East of England,6861,COL
Colchester Town,104900,318126,164444,587470,0,East of England,6853,CET
Coleshill Parkway,125284,24982,13776,164042,0,West Midlands,9882,CEH
Collingham,98900,4488,4686,108074,0,East Midlands,6349,CLM
Collington,45174,66760,20266,132200,0,South East,5457,CLL
Colne,20926,39216,6666,66808,0,North West,2562,CNE
Colwall,18924,23038,10440,52402,0,West Midlands,4876,CWL
Colwyn Bay,116338,124576,18014,258928,241,Wales,2451,CWB
Combe (Oxon),978,110,310,1398,0,South East,3005,CME
Commondale,456,1220,618,2294,0,Yorkshire and The Humber,7515,COM
Congleton,45164,200310,10418,255892,0,North West,1227,CNG
Conisbrough,27034,24760,9802,61596,0,Yorkshire and The Humber,6488,CNS
Connel Ferry,2580,2100,13940,18620,0,Scotland,8708,CON
Conon Bridge,8442,1532,924,10898,0,Scotland,6393,CBD
Cononley,37660,84192,33548,155400,0,Yorkshire and The Humber,8470,CEY
Conway Park,205302,279438,164912,649652,0,North West,3624,CNP
Conwy,28706,21834,2028,52568,0,Wales,2486,CNW
Cooden Beach,18768,65686,12970,97424,0,South East,5458,COB
Cookham,55220,67574,28808,151602,0,South East,3019,COO
Cooksbridge,22506,27942,11772,62220,0,South East,5336,CBR
Coombe Junction Halt,14,106,0,120,0,South West,3570,COE
Copplestone,12498,12072,5810,30380,0,South West,5821,COP
Corbridge,11242,41252,3174,55668,0,North East,7504,CRB
Corby,60470,305026,36748,402244,146,East Midlands,1847,COR
Corfe Castle,0,0,0,0,0,South West,7765,CFC
Corkerhill,57652,105842,20502,183996,0,Scotland,9627,CKH
Corkickle,22618,19742,8708,51068,0,North West,2049,CKL
Corpach,1690,1168,0,2858,0,Scotland,8824,CPA
Corrour,8560,5548,0,14108,0,Scotland,8825,CRR
Coryton,39520,1868,12496,53884,0,Wales,3905,COY
Coseley,137752,221462,156982,516196,0,West Midlands,1143,CSY
Cosford,20510,35430,6412,62352,0,West Midlands,4617,COS
Cosham,232276,451536,81346,765158,0,South East,5896,CSA
Cottingham,31070,135528,43956,210554,0,Yorkshire and The Humber,8056,CGM
Cottingley,25550,22104,13762,61416,0,Yorkshire and The Humber,8505,COT
Coulsdon South,617572,689588,248594,1555754,0,London,5408,CDS
Coulsdon Town,33310,55690,10896,99896,0,London,5382,CDN
Coventry,1494346,3645114,837198,5976658,344911,West Midlands,1030,COV
Coventry Arena,45324,59780,2556,107660,0,West Midlands,7416,CAA
Cowden (Kent),13856,17128,10128,41112,0,South East,5409,CWN
Cowdenbeath,37876,51578,4624,94078,0,Scotland,9185,COW
Cradley Heath,129306,240036,170148,539490,0,West Midlands,4639,CRA
Craigendoran,26700,47470,67534,141704,0,Scotland,9970,CGD
Cramlington,59120,64198,10516,133834,0,North East,7579,CRM
Cranbrook (Devon),17874,73564,11800,103238,0,South West,9850,CBK
Craven Arms,42962,37170,12868,93000,1850,West Midlands,3634,CRV
Crawley,348554,609188,203008,1160750,3065,South East,5484,CRW
Crayford,389274,400546,174948,964768,0,London,5100,CRY
Crediton,84768,34308,14100,133176,0,South West,5754,CDI
Cressing (Essex),11012,15626,12656,39294,0,East of England,6837,CES
Cressington,79432,286070,118672,484174,0,North West,2225,CSG
Creswell,19688,15054,2336,37078,0,East Midlands,1874,CWD
Crewe,611818,2180186,130750,2922754,1072874,North West,1243,CRE
Crewkerne,10976,105606,40980,157562,0,South West,5832,CKN
Crews Hill,32134,57832,13982,103948,0,London,6007,CWH
Crianlarich,5580,7790,0,13370,64981,Scotland,8826,CNR
Criccieth,17998,7450,770,26218,0,Wales,4312,CCC
Cricklewood,255192,424688,140822,820702,0,London,1519,CRI
Croftfoot,42162,110076,33254,185492,0,Scotland,9778,CFF
Crofton Park,237928,269212,68776,575916,0,London,5078,CFT
Cromer,64612,167042,12640,244294,0,East of England,7295,CMR
Cromford,11880,21850,1598,35328,0,East Midlands,1822,CMF
Crookston,49576,81724,17330,148630,0,Scotland,9628,CKT
Cross Gates,175420,140976,70976,387372,0,Yorkshire and The Humber,8473,CRG
Crossflatts,94706,143504,137356,375566,0,Yorkshire and The Humber,8554,CFL
Crosshill,51444,123138,37396,211978,0,Scotland,9814,COI
Crosskeys,60952,2370,8750,72072,0,Wales,9902,CKY
Crossmyloof,209796,363596,43812,617204,0,Scotland,9796,CMY
Croston,15862,19458,3438,38758,0,North West,2313,CSO
Crouch Hill,227328,333288,165870,726486,0,London,7406,CRH
Crowborough,74686,80058,72394,227138,0,South East,5325,COH
Crowhurst,6966,16250,13228,36444,0,South East,5233,CWU
Crowle,1284,3574,912,5770,0,Yorkshire and The Humber,6524,CWE
Crowthorne,63708,100864,26228,190800,0,South East,5628,CRN
Croy,347766,595720,117186,1060672,0,Scotland,9943,CRO
Crystal Palace,783956,1273094,354954,2412004,114639,London,5356,CYP
Cuddington,23392,33042,9630,66064,0,North West,2305,CUD
Cuffley,233026,279252,57542,569820,0,East of England,6008,CUF
Culham,33302,21012,26438,80752,0,South East,3107,CUM
Culrain,216,88,0,304,0,Scotland,8625,CUA
Cumbernauld,61462,65442,13188,140092,3445,Scotland,9721,CUB
Cupar,46902,72180,3076,122158,0,Scotland,9121,CUP
Curriehill,40756,24676,3860,69292,0,Scotland,9218,CUH
Custom House,1540304,2915130,817064,5272498,0,London,6561,CUS
Cuxton,20592,14976,13032,48600,0,South East,5201,CUX
Cwmbach,25934,982,6078,32994,0,Wales,3981,CMH
Cwmbran,213528,82926,56602,353056,0,Wales,3738,CWM
Cynghordy,752,360,0,1112,0,Wales,4147,CYN
Dagenham Dock,159066,161508,65896,386470,0,London,7440,DDK
Daisy Hill,65302,59940,36046,161288,0,North West,2777,DSY
Dalgety Bay,57282,72678,13462,143422,0,Scotland,9135,DAG
Dalmally,2130,1358,10144,13632,0,Scotland,8711,DAL
Dalmarnock,73588,158668,23282,255538,0,Scotland,9790,DAK
Dalmeny,109398,189398,43532,342328,0,Scotland,9415,DAM
Dalmuir,183722,269272,108538,561532,16150,Scotland,9992,DMR
Dalreoch,45380,73492,60628,179500,0,Scotland,9864,DLR
Dalry,43222,77204,18314,138740,0,Scotland,9483,DLY
Dalston (Cumbria),7226,17630,12544,37400,0,North West,2077,DLS
Dalston Junction,1348922,3142966,540582,5032470,0,London,1443,DLJ
Dalston Kingsland,1167496,2681172,715546,4564214,0,London,1429,DLK
Dalton (Cumbria),12958,45564,10274,68796,0,North West,1957,DLT
Dalwhinnie,1566,1266,0,2832,0,Scotland,8628,DLW
Danby,532,4540,524,5596,0,Yorkshire and The Humber,7915,DNY
Danescourt,32088,1628,6158,39874,0,Wales,3797,DCT
Danzey,2250,2504,106,4860,0,West Midlands,4519,DZY
Darlington,273978,1828246,117454,2219678,471935,North East,7877,DAR
Darnall,7774,6036,3044,16854,0,Yorkshire and The Humber,6729,DAN
Darsham,8226,45698,2040,55964,0,East of England,7211,DSM
Dartford,1375332,2105100,510642,3991074,403801,South East,5101,DFD
Darton,47318,35190,19022,101530,0,Yorkshire and The Humber,8420,DRT
Darwen,63958,165068,40120,269146,0,North West,2576,DWN
Datchet,71200,117940,28674,217814,0,South East,5668,DAT
Davenport,95208,77296,60170,232674,0,North West,2770,DVN
Dawlish,80168,344098,86308,510574,0,South West,3408,DWL
Dawlish Warren,27076,198138,7846,233060,0,South West,3409,DWW
Deal,66352,278254,83018,427624,0,South East,5011,DEA
Dean (Wilts),3876,20658,3696,28230,0,South West,5942,DEN
Deansgate,198570,690136,79384,968090,0,North West,2963,DGT
Deganwy,9006,4032,2048,15086,0,Wales,2480,DGY
Deighton,20342,27940,13820,62102,0,Yorkshire and The Humber,8441,DHN
Delamere,14640,31482,2760,48882,0,North West,2306,DLM
Denby Dale,46962,30904,22218,100084,0,Yorkshire and The Humber,8432,DBD
Denham,79448,53416,43228,176092,0,South East,3052,DNM
Denham Golf Club,10706,7776,2154,20636,0,South East,3060,DGC
Denmark Hill,2058794,2386948,1108578,5554320,482855,London,5421,DMK
Dent,1084,8152,0,9236,0,North West,2103,DNT
Denton,16,18,0,34,0,North West,2855,DTN
Deptford,405260,689268,381232,1475760,0,London,5145,DEP
Derby,701488,2523128,152688,3377304,403208,East Midlands,1823,DBY
Derby Road (Ipswich),22120,44434,6644,73198,0,East of England,7212,DBR
Devonport,8982,16538,9450,34970,0,South West,3579,DPT
Dewsbury,399126,432058,200658,1031842,0,Yorkshire and The Humber,8326,DEW
Didcot Parkway,409126,1444234,476344,2329704,545574,South East,3030,DID
Digby and Sowton,231484,75528,583968,890980,0,South West,5753,DIG
Dilton Marsh,6258,4218,1600,12076,0,South West,5502,DMH
Dinas (Rhondda),23686,968,4798,29452,0,Wales,3901,DMG
Dinas Powys,58030,5388,8102,71520,0,Wales,3830,DNS
Dingle Road,95072,6568,15650,117290,0,Wales,3861,DGL
Dingwall,40860,12488,2188,55536,304,Scotland,8632,DIN
Dinsdale,16878,39054,13538,69470,0,North East,7897,DND
Dinting,35204,23984,20934,80122,0,East Midlands,2893,DTG
Disley,38138,48964,24342,111444,0,North West,2765,DSL
Diss,109794,386348,63824,559966,0,East of England,7348,DIS
Dockyard (Devonport),2768,5754,438,8960,0,South West,3588,DOC
Dodworth,18414,14532,5670,38616,0,Yorkshire and The Humber,6781,DOD
Dolau,352,328,0,680,0,Wales,4188,DOL
Doleham,128,78,344,550,0,South East,5036,DLH
Dolgarrog,446,188,0,634,0,Wales,2538,DLG
Dolwyddelan,2066,1470,10,3546,0,Wales,2452,DWD
Doncaster,486954,2890278,257290,3634522,987406,Yorkshire and The Humber,6417,DON
Dorchester South,76208,309428,10250,395886,405,South West,5961,DCH
Dorchester West,15822,64246,2128,82196,43,South West,5962,DCW
Dore and Totley,55028,104510,7320,166858,0,Yorkshire and The Humber,6690,DOR
Dorking (Deepdene),115046,240038,66488,421572,217626,South East,5412,DPD
Dorking (Main),189756,395914,109664,695334,74693,South East,5357,DKG
Dorking West,9128,19048,5276,33452,249,South East,5297,DKT
Dormans,32804,31962,38094,102860,0,South East,5413,DMS
Dorridge,122200,302086,150998,575284,0,West Midlands,4525,DDG
Dove Holes,2480,5130,4036,11646,0,East Midlands,2766,DVH
Dover Priory,186744,555790,153054,895588,70905,South East,5033,DVP
Dovercourt,30084,56512,43746,130342,0,East of England,6901,DVC
Dovey Junction,8406,784,0,9190,4370,Wales,4436,DVY
Downham Market,99018,216442,70810,386270,0,East of England,7055,DOW
Drayton Green,6404,7350,2328,16082,0,London,3099,DRG
Drayton Park,226742,239244,50748,516734,0,London,6000,DYP
Drem,53676,42902,6192,102770,0,Scotland,9317,DRM
Driffield,33142,169242,37710,240094,0,Yorkshire and The Humber,8057,DRF
Drigg,1744,4306,208,6258,0,North West,1994,DRI
Droitwich Spa,199784,113310,83960,397054,34666,West Midlands,4878,DTW
Dronfield,64260,84552,13572,162384,0,East Midlands,6616,DRO
Drumchapel,74022,143776,18294,236092,0,Scotland,9994,DMC
Drumfrochar,13590,26476,6914,46980,0,Scotland,9967,DFR
Drumgelloch,74368,110978,39086,224432,0,Scotland,9757,DRU
Drumry,39994,82982,13146,136122,0,Scotland,9993,DMY
Duddeston,201998,104602,78400,385000,0,West Midlands,1040,DUD
Dudley Port,94644,149790,71420,315854,0,West Midlands,1212,DDP
Duffield,23810,20380,3292,47482,0,East Midlands,1691,DFI
Duirinish,470,144,0,614,0,Scotland,8681,DRN
Duke Street,45158,88952,11964,146074,0,Scotland,9906,DST
Dullingham,11356,5910,8048,25314,0,East of England,7027,DUL
Dumbarton Central,115696,201370,81648,398714,50889,Scotland,9866,DBC
Dumbarton East,77300,139754,35534,252588,0,Scotland,9868,DBE
Dumbreck,39776,69552,9240,118568,0,Scotland,9622,DUM
Dumfries,30304,258460,2032,290796,540,Scotland,9490,DMF
Dumpton Park,7798,11964,3856,23618,0,South East,5034,DMP
Dunbar,19560,282180,17540,319280,0,Scotland,9397,DUN
Dunblane,107270,233910,19238,360418,0,Scotland,8713,DBL
Duncraig,378,84,0,462,0,Scotland,8682,DCG
Dundee,436434,973894,43232,1453560,68073,Scotland,9039,DEE
Dunfermline City,139482,189590,23998,353070,0,Scotland,9186,DFE
Dunfermline Queen Margaret,56056,76604,7408,140068,0,Scotland,9187,DFL
Dunkeld and Birnam,15082,23106,228,38416,0,Scotland,8763,DKD
Dunlop,18274,33760,5748,57782,0,Scotland,9492,DNL
Dunrobin Castle,1154,274,0,1428,0,Scotland,8642,DNO
Dunston,5478,16724,2336,24538,0,North East,7744,DOT
Dunton Green,49870,97618,42402,189890,0,South East,5102,DNG
Durham,59574,2260842,126318,2446734,3765,North East,7745,DHM
Durrington-On-Sea,111028,219414,96852,427294,0,South East,5282,DUR
Dyce,128962,110958,20080,260000,0,Scotland,8905,DYC
Dyffryn Ardudwy,11050,3184,1522,15756,0,Wales,4455,DYF
Eaglescliffe,20604,166742,12662,200008,0,North East,7916,EAG
Ealing Broadway,2331306,4589210,1316840,8237356,74728,London,3190,EAL
Earlestown,81264,158292,35398,274954,51348,North West,2292,ERL
Earley,102924,185976,62262,351162,0,South East,5694,EAR
Earlsfield,1670348,2145302,918582,4734232,0,London,5584,EAD
Earlswood (Surrey),101828,115926,55460,273214,0,South East,5414,ELD
Earlswood (West Midlands),4952,15202,4650,24804,0,West Midlands,4520,EWD
East Croydon,5880990,9413458,3220010,18514458,3932747,London,5355,ECR
East Didsbury,61218,123412,23440,208070,0,North West,2949,EDY
East Dulwich,384742,487038,168918,1040698,0,London,5358,EDW
East Farleigh,9892,11980,6892,28764,0,South East,5234,EFL
East Garforth,66980,50312,41640,158932,0,Yorkshire and The Humber,8472,EGF
East Grinstead,266136,367982,254630,888748,0,South East,5486,EGR
East Kilbride,176906,326698,70114,573718,0,Scotland,9793,EKL
East Malling,19194,29278,17074,65546,0,South East,5134,EML
East Midlands Parkway,56272,240946,12646,309864,12120,East Midlands,1901,EMD
East Tilbury,126474,88522,70662,285658,0,East of England,7471,ETL
East Worthing,72278,122762,165912,360952,0,South East,5283,EWR
Eastbourne,385208,1871962,944358,3201528,39871,South East,5448,EBN
Eastbrook,86592,4224,23568,114384,0,Wales,3795,EBK
Easterhouse,86862,117752,25964,230578,0,Scotland,9894,EST
Eastham Rake,123966,167008,82962,373936,0,North West,2128,ERA
Eastleigh,263312,612224,214128,1089664,93127,South East,5899,ESL
Eastrington,270,1390,0,1660,0,Yorkshire and The Humber,8114,EGN
Ebbsfleet International,503318,799908,255644,1558870,82975,South East,5566,EBD
Ebbw Vale Parkway,25056,2438,2958,30452,0,Wales,9915,EBV
Ebbw Vale Town,150656,14046,34914,199616,0,Wales,3628,EBB
Eccles (Manchester),104194,77584,34060,215838,0,North West,2950,ECC
Eccles Road,464,152,1214,1830,0,East of England,7370,ECS
Eccleston Park,22410,24530,12182,59122,0,North West,2227,ECL
Edale,32482,83882,618,116982,0,East Midlands,2824,EDL
Eden Park,178868,202442,37018,418328,0,London,5056,EDN
Edenbridge (Kent),32116,56890,64532,153538,39025,South East,5473,EBR
Edenbridge Town,58798,104154,118144,281096,8188,South East,5359,EBT
Edge Hill,86916,54532,34098,175546,5970,North West,2169,EDG
Edinburgh,3720284,13883536,608808,18212628,1237283,Scotland,9328,EDB
Edinburgh Gateway,102632,63952,19180,185764,7755,Scotland,6545,EGY
Edinburgh Park,204390,165210,26014,395614,0,Scotland,9395,EDP
Edmonton Green,937288,1447922,476080,2861290,18649,London,6941,EDR
Effingham Junction,72408,85898,27108,185414,10515,South East,5642,EFF
Eggesford,11396,20150,12176,43722,0,South West,5822,EGG
Egham,600156,762210,196978,1559344,0,South East,5669,EGH
Egton,428,4472,3742,8642,0,Yorkshire and The Humber,7918,EGT
Elephant and Castle,578106,734156,368402,1680664,438837,London,5246,EPH
Elgin,64650,158414,5838,228902,0,Scotland,8977,ELG
Ellesmere Port,134828,250180,43544,428552,3894,North West,2121,ELP
Elmers End,244422,271568,100246,616236,0,London,5049,ELE
Elmstead Woods,339402,320538,120696,780636,0,London,5135,ESD
Elmswell,38994,40190,12708,91892,0,East of England,7349,ESW
Elsecar,70564,46338,38094,154996,0,Yorkshire and The Humber,6667,ELR
Elsenham (Essex),59600,61282,70864,191746,0,East of England,6832,ESM
Elstree and Borehamwood,916050,1148544,417064,2481658,0,East of England,1542,ELS
Eltham,566276,670316,226022,1462614,0,London,5103,ELW
Elton and Orston,46,10,0,56,0,East Midlands,6238,ELO
Ely,487680,1079570,326764,1894014,344826,East of England,7068,ELY
Emerson Park,130204,96940,12974,240118,0,London,7473,EMP
Emsworth,91148,148358,66666,306172,4049,South East,5257,EMS
Energlyn and Churchill Park,48706,1570,15582,65858,0,Wales,375,ECP
Enfield Chase,373006,508940,115296,997242,2673,London,6010,ENC
Enfield Lock,408648,655506,119464,1183618,0,London,6815,ENL
Enfield Town,675824,962296,193112,1831232,868,London,6959,ENF
Entwistle,3474,14830,2122,20426,0,North West,2747,ENT
Epsom (Surrey),1106806,1412816,367332,2886954,113345,South East,5360,EPS
Epsom Downs,44520,43504,17660,105684,0,South East,5361,EPD
Erdington,118556,173210,105458,397224,0,West Midlands,1041,ERD
Eridge,29152,26466,15202,70820,0,South East,5459,ERI
Erith,268032,356634,164862,789528,0,London,5104,ERH
Esher,302716,283856,165750,752322,0,South East,5558,ESH
Eskbank,79110,117386,6238,202734,0,Scotland,3776,EKB
Essex Road,229846,255800,74320,559966,0,London,6004,EXR
Etchingham,37094,83900,46366,167360,0,South East,5217,ETC
Euxton Balshaw Lane,16970,35934,1180,54084,0,North West,2080,EBA
Evesham,52372,168456,24314,245142,298,West Midlands,4740,EVE
Ewell East,183478,177916,63324,424718,0,South East,5415,EWE
Ewell West,329966,370468,108000,808434,0,South East,5586,EWW
Exeter Central,670552,1463460,474372,2608384,314455,South West,5755,EXC
Exeter St David's,321222,2164386,131714,2617322,1225850,South West,3410,EXD
Exeter St Thomas,52534,118890,92972,264396,0,South West,3414,EXT
Exhibition Centre (Glasgow),278880,733202,145856,1157938,0,Scotland,9914,EXG
Exmouth,137526,641724,119126,898376,0,South West,5756,EXM
Exton,11976,7866,3528,23370,0,South West,5760,EXN
Eynsford,43354,48200,32388,123942,0,South East,5065,EYN
Fairbourne,20036,7052,2300,29388,0,Wales,4416,FRB
Fairfield,8948,3816,3808,16572,0,North West,2780,FRF
Fairlie,10060,18688,1226,29974,0,Scotland,9452,FRL
Fairwater,37348,1460,14580,53388,0,Wales,3873,FRW
Falconwood,306944,325522,104872,737338,0,London,5137,FCN
Falkirk Grahamston,181544,267730,39330,488604,59878,Scotland,9930,FKG
Falkirk High,229414,338330,49700,617444,2189,Scotland,9931,FKK
Falls Of Cruachan,670,218,0,888,0,Scotland,8726,FOC
Falmer,314652,742826,100186,1157664,0,South East,5337,FMR
Falmouth Docks,8970,97116,17308,123394,0,South West,3508,FAL
Falmouth Town,20896,202210,20406,243512,0,South West,3591,FMT
Fareham,374776,868914,171466,1415156,125357,South East,5900,FRM
Farnborough (Main),624020,913230,402722,1939972,5162,South East,5521,FNB
Farnborough North,134920,197450,87074,419444,2150,South East,5688,FNN
Farncombe,174844,162478,99480,436802,0,South East,5643,FNC
Farnham,451698,564224,187574,1203496,21176,South East,5545,FNH
Farningham Road,40264,46982,31954,119200,0,South East,5105,FNR
Farnworth,23562,14914,9526,48002,0,North West,2811,FNW
Farringdon,12023796,15911166,3524942,31459904,640172,London,577,ZFD
Fauldhouse,14266,16868,1606,32740,0,Scotland,9245,FLD
Faversham,288838,557152,443554,1289544,185002,South East,5167,FAV
Faygate,3796,1118,1020,5934,0,South East,5493,FGT
Fazakerley,170982,457656,270798,899436,0,North West,2126,FAZ
Fearn,2696,568,490,3754,0,Scotland,8637,FRN
Featherstone,27334,31424,6314,65072,0,Yorkshire and The Humber,8544,FEA
Felixstowe,54608,149388,14546,218542,0,East of England,7214,FLX
Feltham,1094338,1355358,626882,3076578,0,London,5559,FEL
Feniton,8480,32962,10606,52048,0,South West,5808,FNT
Fenny Stratford,3196,4704,3450,11350,0,South East,1377,FEN
Fernhill,17134,786,1570,19490,0,Wales,3862,FER
Ferriby,12474,22672,6424,41570,0,Yorkshire and The Humber,8061,FRY
Ferryside,9572,4318,948,14838,0,Wales,4074,FYS
Ffairfach,2024,982,0,3006,0,Wales,4066,FFA
Filey,26066,127086,10070,163222,0,Yorkshire and The Humber,8062,FIL
Filton Abbey Wood,260098,234238,27138,521474,0,South West,3235,FIT
Finchley Road and Frognal,492440,744818,332698,1569956,0,London,1445,FNY
Finsbury Park,3037342,4481598,1040092,8559032,3360327,London,6119,FPK
Finstock,454,60,192,706,0,South East,3012,FIN
Fishbourne (Sussex),22710,23028,13234,58972,0,South East,5261,FSB
Fishersgate,30460,44896,15096,90452,0,South East,5284,FSG
Fishguard and Goodwick,2814,10628,0,13442,0,Wales,6680,FGW
Fishguard Harbour,1520,8768,0,10288,0,Wales,4076,FGH
Fiskerton,12952,7304,1018,21274,0,East Midlands,6351,FSK
Fitzwilliam,120212,78702,40318,239232,833,Yorkshire and The Humber,8583,FZW
Five Ways,574444,529004,355406,1458854,0,West Midlands,4503,FWY
Fleet,358702,496944,235838,1091484,451,South East,5522,FLE
Flimby,3226,6238,1110,10574,0,North West,2026,FLM
Flint,133340,87138,13842,234320,0,Wales,2513,FLN
Flitwick,276754,574928,238222,1089904,0,East of England,1532,FLT
Flixton,50980,25250,13890,90120,0,North West,2935,FLI
Flowery Field,60518,45676,38690,144884,0,North West,2786,FLF
Folkestone Central,134854,506604,170228,811686,15263,South East,5035,FKC
Folkestone West,101402,380930,127998,610330,1869,South East,5027,FKW
Ford,29506,46540,18082,94128,97834,South East,5258,FOD
Forest Gate,1477820,2607378,798374,4883572,0,London,6876,FOG
Forest Hill,1218380,2062116,476786,3757282,0,London,5362,FOH
Formby,266176,619148,177334,1062658,0,North West,2354,FBY
Forres,27280,67038,2712,97030,0,Scotland,8638,FOR
Forsinard,662,264,10,936,0,Scotland,8639,FRS
Fort Matilda,26050,47934,11202,85186,0,Scotland,9675,FTM
Fort William,38326,107238,0,145564,204,Scotland,8827,FTW
Four Oaks,124422,216798,156426,497646,0,West Midlands,1042,FOK
Foxfield,2266,8668,2388,13322,0,North West,2046,FOX
Foxton,30968,43648,13178,87794,0,East of England,7029,FXN
Frant,22164,43206,25274,90644,0,South East,5218,FRT
Fratton,436146,1182924,156686,1775756,154235,South East,5509,FTN
Freshfield,107358,312018,79512,498888,0,North West,2355,FRE
Freshford,18640,19132,6322,44094,0,South West,3344,FFD
Frimley,65464,73888,24566,163918,0,South East,5683,FML
Frinton-on-Sea,29512,95444,34486,159442,0,East of England,6854,FRI
Frizinghall,119766,72430,180446,372642,0,Yorkshire and The Humber,8556,FZH
Frodsham,114428,60848,7324,182600,0,North West,2284,FRD
Frome,76452,125840,4796,207088,394,South West,5707,FRO
Fulwell,141882,138204,42082,322168,0,London,5587,FLW
Furness Vale,5534,11938,2554,20026,0,East Midlands,2952,FNV
Furze Platt,38518,43956,34056,116530,0,South East,3144,FZP
Gainsborough Central,1046,858,46,1950,83,East Midlands,6465,GNB
Gainsborough Lea Road,58782,100290,9868,168940,223,East Midlands,6424,GBL
Galashiels,102944,156504,9272,268720,0,Scotland,9329,GAL
Garelochhead,6008,3824,198,10030,0,Scotland,9971,GCH
Garforth,201600,170420,52764,424784,0,Yorkshire and The Humber,8474,GRF
Gargrave,7808,23964,954,32726,0,Yorkshire and The Humber,2654,GGV
Garrowhill,79590,157358,41438,278386,0,Scotland,9904,GAR
Garscadden,38912,95476,15686,150074,0,Scotland,9979,GRS
Garsdale,2820,11574,100,14494,0,North West,2104,GSD
Garston (Hertfordshire),16726,14726,10494,41946,0,East of England,1559,GSN
Garswood,25182,63858,27510,116550,0,North West,2335,GSW
Gartcosh,51684,67968,15210,134862,0,Scotland,9723,GRH
Garth (Bridgend County),13234,422,836,14492,0,Wales,3961,GMG
Garth (Powys),282,304,0,586,0,Wales,4148,GTH
Garve,1440,1606,244,3290,0,Scotland,8640,GVE
Gathurst,35496,26216,18742,80454,0,North West,2397,GST
Gatley,96766,156366,34006,287138,0,North West,2953,GTY
Gatwick Airport,7747846,8418468,341666,16507980,852806,South East,5416,GTW
Georgemas Junction,752,566,0,1318,0,Scotland,8641,GGJ
Gerrards Cross,406766,363112,131268,901146,34829,South East,3051,GER
Gidea Park,1197504,1398436,208652,2804592,0,London,6877,GDP
Giffnock,72364,144150,15638,232152,0,Scotland,9794,GFN
Giggleswick,3798,9046,998,13842,0,Yorkshire and The Humber,2655,GIG
Gilberdyke,12038,34364,8596,54998,678,Yorkshire and The Humber,8117,GBD
Gilfach Fargoed,1998,200,1704,3902,0,Wales,4022,GFF
Gillingham (Dorset),41408,206578,29948,277934,0,South West,5796,GIL
Gillingham (Kent),617732,927864,574864,2120460,602044,South East,5169,GLM
Gilshochill,13516,34634,5516,53666,0,Scotland,9956,GSC
Gipsy Hill,422006,472944,188242,1083192,0,London,5363,GIP
Girvan,23142,48470,2132,73744,0,Scotland,9501,GIR
Glaisdale,536,3358,14964,18858,0,Yorkshire and The Humber,7921,GLS
Glan Conwy,2128,1412,80,3620,0,Wales,2454,GCW
Glasgow Central,5557214,12946504,2264236,20767954,2217140,Scotland,9813,GLC
Glasgow Queen Street,3072938,8373698,837100,12283736,1285677,Scotland,9950,GLQ
Glasshoughton,66018,37116,10162,113296,0,Yorkshire and The Humber,8360,GLH
Glazebrook,10242,9236,4818,24296,0,North West,2301,GLZ
Gleneagles,22076,52908,1386,76370,0,Scotland,8715,GLE
Glenfinnan,5646,7774,0,13420,0,Scotland,8828,GLF
Glengarnock,69172,126524,39852,235548,0,Scotland,9503,GLG
Glenrothes with Thornton,17318,23916,1370,42604,0,Scotland,9301,GLT
Glossop,221440,204938,157944,584322,0,East Midlands,2895,GLO
Gloucester,428092,953610,71246,1452948,63110,South West,4760,GCR
Glynde,18768,34182,7576,60526,0,South East,5338,GLY
Gobowen,114650,71912,8172,194734,0,West Midlands,4457,GOB
Godalming,578080,420378,218282,1216740,0,South East,5629,GOD
Godley,25268,25106,9538,59912,0,North West,2948,GDL
Godstone,16864,27784,19362,64010,0,South East,5474,GDN
Goldthorpe,25612,17362,12064,55038,0,Yorkshire and The Humber,8284,GOE
Golf Street,722,174,10,906,0,Scotland,9096,GOF
Golspie,3046,1010,0,4056,0,Scotland,8643,GOL
Gomshall,13554,28946,5128,47628,0,South East,5298,GOM
Goodmayes,1335820,2099488,696116,4131424,0,London,6878,GMY
Goole,59018,178648,23684,261350,1119,Yorkshire and The Humber,8025,GOO
Goostrey,14518,16484,1368,32370,0,North West,1220,GTR
Gordon Hill,398638,467444,126020,992102,0,London,6028,GDH
Gorebridge,41156,48564,2766,92486,0,Scotland,6391,GBG
Goring and Streatley,70504,179944,37726,288174,0,South East,3033,GOR
Goring-By-Sea,113680,213208,157484,484372,0,South East,5272,GBS
Gorton,22738,16170,13034,51942,0,North West,2962,GTO
Gospel Oak,714118,1231714,277850,2223682,1737753,London,1409,GPO
Gourock,104920,187424,31934,324278,0,Scotland,9635,GRK
Gowerton,65732,36474,16350,118556,0,Wales,4131,GWN
Goxhill,3022,6632,174,9828,0,Yorkshire and The Humber,6206,GOX
Grange Park,162172,182532,25120,369824,0,London,6029,GPK
Grange-Over-Sands,17764,99302,10782,127848,0,North West,1965,GOS
Grangetown (Cardiff),164782,6202,31184,202168,5057,Wales,3839,GTN
Grantham,45790,1098104,116540,1260434,228918,East Midlands,6469,GRA
Grateley,27062,105308,40478,172848,0,South East,5514,GRT
Gravelly Hill,115094,124302,117988,357384,0,West Midlands,1132,GVH
Gravesend,716158,992194,547704,2256056,443733,South East,5172,GRV
Grays,1168466,1302276,616182,3086924,101106,East of England,7443,GRY
Great Ayton,1576,8532,10,10118,0,Yorkshire and The Humber,7922,GTA
Great Bentley,16554,25498,22808,64860,0,East of England,6855,GRB
Great Chesterford,25734,37002,23360,86096,0,East of England,7032,GRC
Great Coates,2144,2294,0,4438,0,Yorkshire and The Humber,6275,GCT
Great Malvern,133364,155042,79146,367552,138,West Midlands,4892,GMV
Great Missenden,163694,145542,66606,375842,0,South East,1463,GMN
Great Yarmouth,61352,319752,12218,393322,185,East of England,7328,GYM
Green Lane,148186,127556,76136,351878,0,North West,2218,GNL
Green Road,2246,4104,858,7208,0,North West,1996,GNR
Greenbank,52474,61100,70742,184316,0,North West,2325,GBK
Greenfaulds,29816,38730,10602,79148,0,Scotland,9725,GRL
Greenfield,106018,99342,41204,246564,0,North West,2900,GNF
Greenford,54350,60836,10866,126052,0,London,3136,GFD
Greenhithe for Bluewater,224392,229442,234956,688790,0,South East,5138,GNH
Greenock Central,54204,125192,25754,205150,237,Scotland,9681,GKC
Greenock West,82192,138946,47134,268272,0,Scotland,9682,GKW
Greenwich,731458,1201754,433808,2367020,0,London,5146,GNW
Gretna Green,7770,29614,20,37404,0,Scotland,9610,GEA
Grimsby Docks,1520,952,486,2958,0,Yorkshire and The Humber,6276,GMD
Grimsby Town,41850,268660,5710,316220,14427,Yorkshire and The Humber,6280,GMB
Grindleford,17036,61150,1470,79656,0,East Midlands,2825,GRN
Grosmont,954,7600,2730,11284,0,Yorkshire and The Humber,8155,GMT
Grove Park,667822,890186,451352,2009360,276182,London,5139,GRP
Guide Bridge,96202,68854,54128,219184,3382,North West,2955,GUI
Guildford,1782862,2767468,734384,5284714,681231,South East,5631,GLD
Guiseley,371284,269026,230704,871014,0,Yorkshire and The Humber,8567,GSY
Gunnersbury,707178,764416,303930,1775524,0,London,5588,GUN
Gunnislake,3688,35816,11068,50572,0,South West,3563,GSL
Gunton,8268,18236,1942,28446,0,East of England,7299,GNT
Gwersyllt,14358,1750,3816,19924,0,Wales,4300,GWE
Gypsy Lane,9396,19658,2572,31626,0,North East,7930,GYP
Habrough,7118,24382,3576,35076,357,Yorkshire and The Humber,6281,HAB
Hackbridge,267616,292208,162130,721954,0,London,5364,HCB
Hackney Central,1183688,2457334,565038,4206060,1466758,London,6977,HKC
Hackney Downs,882316,1561256,306708,2750280,1563253,London,6867,HAC
Hackney Wick,934388,1846794,300886,3082068,1629,London,6978,HKW
Haddenham and Thame Parkway,279574,237154,137804,654532,0,South East,3053,HDM
Haddiscoe,3348,6562,394,10304,0,East of England,7300,HAD
Hadfield,84902,79652,60408,224962,0,East Midlands,2896,HDF
Hadley Wood,124012,149548,22326,295886,0,London,6075,HDW
Hag Fold,23434,19410,11196,54040,0,North West,2585,HGF
Haggerston,1030836,1840768,285330,3156934,0,London,1022,HGG
Hagley,47744,46920,267146,361810,0,West Midlands,4577,HAG
Hairmyres,141832,201134,66768,409734,0,Scotland,9810,HMY
Hale (Manchester),32910,36340,25804,95054,0,North West,2845,HAL
Halesworth,28838,63886,6852,99576,0,East of England,7266,HAS
Halewood,19894,33654,10654,64202,0,North West,2295,HED
Halifax,488914,785390,144298,1418602,56092,Yorkshire and The Humber,8411,HFX
Hall Green,77976,102540,81962,262478,0,West Midlands,4521,HLG
Hall Road,36404,258648,36456,331508,0,North West,2229,HLR
Halling,16428,17242,28116,61786,0,South East,5173,HAI
Hall-I'-Th'-Wood,55424,41328,46272,143024,0,North West,2572,HID
Haltwhistle,24610,46414,5986,77010,0,North East,7568,HWH
Ham Street,10628,30878,17586,59092,0,South East,5037,HMT
Hamble,21926,30562,27780,80268,0,South East,5947,HME
Hamilton Central,161986,283092,81492,526570,2333,Scotland,9726,HNC
Hamilton West,175192,264748,67972,507912,0,Scotland,9727,HNW
Hammerton,7910,21298,3636,32844,0,Yorkshire and The Humber,8241,HMM
Hampden Park (Sussex),163328,339822,191550,694700,120872,South East,5450,HMD
Hampstead Heath,926766,1615566,429906,2972238,0,London,1413,HDH
Hampton (London),317352,327180,105226,749758,0,London,5560,HMP
Hampton Court,411130,593028,102936,1107094,0,South East,5561,HMC
Hampton Wick,250380,335022,65154,650556,0,London,5589,HMW
Hampton-In-Arden,38002,62932,30248,131182,0,West Midlands,1033,HIA
Hamstead (Birmingham),60048,75920,41948,177916,0,West Midlands,1145,HSD
Hamworthy,36652,75714,3988,116354,0,South West,5940,HAM
Hanborough,86046,132768,43684,262498,0,South East,3007,HND
Handforth,104210,73186,62830,240226,0,North West,2767,HTH
Hanwell,324568,498820,98766,922154,0,London,3191,HAN
Hapton,3704,6350,1948,12002,0,North West,2557,HPN
Harlech,29040,6786,84504,120330,0,Wales,4458,HRL
Harlesden,357696,724328,227774,1309798,0,London,1521,HDN
Harling Road,1432,240,432,2104,0,East of England,7374,HRD
Harlington (Bedfordshire),69752,149854,46602,266208,0,East of England,1533,HLN
Harlow Mill,99502,62402,43478,205382,0,East of England,6804,HWM
Harlow Town,602740,654460,288458,1545658,0,East of England,6827,HWN
Harold Wood,1262700,1655904,350450,3269054,0,London,6879,HRO
Harpenden,734082,1254904,356880,2345866,3861,East of England,1543,HPD
Harrietsham,20792,27882,32368,81042,0,South East,5140,HRM
Harringay,325200,481664,114042,920906,0,London,6012,HGY
Harringay Green Lanes,306284,513864,286274,1106422,0,London,7401,HRY
Harrington,8840,13860,3796,26496,0,North West,2027,HRR
Harrogate,271760,1115368,115432,1502560,1132,Yorkshire and The Humber,8213,HGT
Harrow and Wealdstone,779622,1623542,401364,2804528,337438,London,1397,HRW
Harrow-On-The-Hill,1020080,1498606,97256,2615942,0,London,598,HOH
Hartford (Cheshire),51678,119178,6250,177106,0,North West,2230,HTF
Hartlebury,16826,8056,19302,44184,0,West Midlands,4579,HBY
Hartlepool,113600,391488,47960,553048,1390,North East,8009,HPL
Hartwood,3560,7138,1104,11802,0,Scotland,9246,HTW
Harwich International,30140,41920,23168,95228,0,East of England,6902,HPQ
Harwich Town,18132,41598,27742,87472,0,East of England,6905,HWC
Haslemere,323616,505578,382974,1212168,56812,South East,5633,HSL
Hassocks,232334,540072,247370,1019776,0,South East,5489,HSK
Hastings,277172,1146870,478678,1902720,35074,South East,5219,HGS
Hatch End,126580,398148,19544,544272,0,London,1398,HTE
Hatfield (Herts),855630,1157872,174958,2188460,0,East of England,6070,HAT
Hatfield and Stainforth,10978,18938,7036,36952,5788,Yorkshire and The Humber,6528,HFS
Hatfield Peverel,72274,106742,108380,287396,0,East of England,6845,HAP
Hathersage,24604,46740,1326,72670,0,East Midlands,2826,HSG
Hattersley,29700,23372,16384,69456,0,North West,2604,HTY
Hatton,13024,7656,57508,78188,0,West Midlands,4594,HTN
Havant,396426,1120034,331050,1847510,275582,South East,5532,HAV
Havenhouse,560,640,0,1200,0,East Midlands,6260,HVN
Haverfordwest,39186,57602,1078,97866,0,Wales,4079,HVF
Hawarden,20058,1814,1292,23164,0,Wales,2428,HWD
Hawarden Bridge,1798,166,42,2006,0,Wales,2146,HWB
Hawkhead,49204,92100,25662,166966,0,Scotland,9634,HKH
Haydon Bridge,10904,23650,4276,38830,0,North East,7569,HDB
Haydons Road,108574,110950,45502,265026,0,London,5289,HYR
Hayes (Kent),293760,316484,81142,691386,0,London,5050,HYS
Hayes and Harlington,1602650,3035382,808366,5446398,119677,London,3186,HAY
Hayle,12722,99974,14278,126974,0,South West,3513,HYL
Haymarket,997268,1216172,94976,2308416,426734,Scotland,9419,HYM
Haywards Heath,762028,1804112,828700,3394840,325318,South East,5490,HHE
Hazel Grove,172086,160190,72726,405002,380,North West,2768,HAZ
Headcorn,97072,230860,140476,468408,0,South East,5220,HCN
Headingley,137368,122812,39682,299862,0,Yorkshire and The Humber,8498,HDY
Headstone Lane,108010,239810,37688,385508,0,London,1434,HDL
Heald Green,137406,128064,53350,318820,2889,North West,2860,HDG
Healing,2804,3076,52,5932,0,Yorkshire and The Humber,6283,HLI
Heath High Level,220976,13162,47172,281310,0,Wales,3845,HHL
Heath Low Level,42374,2338,5364,50076,0,Wales,3908,HLL
Heathrow Terminal 4 (Rail Station Only),404798,271086,17702,693586,0,London,7091,HAF
Heathrow Terminal 5 (Rail Station Only),1529236,1024104,66876,2620216,0,London,9846,HWV
Heathrow Terminals 2 and 3 (Rail Station Only),2563718,1716878,112116,4392712,0,London,7090,HXX
Heaton Chapel,224088,166184,90116,480388,0,North West,2861,HTC
Hebden Bridge,205680,416068,58012,679760,33481,Yorkshire and The Humber,8524,HBD
Heckington,21462,10978,5968,38408,0,East Midlands,6220,HEC
Hedge End,81654,196382,61560,339596,0,South East,5893,HDE
Hednesford,65578,101458,24792,191828,0,West Midlands,1148,HNF
Heighington,10668,9006,15354,35028,0,North East,7887,HEI
Helensburgh Central,147898,293854,57922,499674,45,Scotland,9981,HLC
Helensburgh Upper,2758,5482,1080,9320,737,Scotland,9982,HLU
Hellifield,4038,23292,182,27512,1265,Yorkshire and The Humber,2656,HLD
Helmsdale,2448,1036,0,3484,0,Scotland,8647,HMS
Helsby,51168,35538,2552,89258,55321,North West,2149,HSB
Hemel Hempstead,429320,716320,161046,1306686,9093,East of England,1391,HML
Hendon,292478,369198,222118,883794,0,London,1522,HEN
Hengoed,79296,3862,22746,105904,0,Wales,4028,HNG
Henley-In-Arden,19962,27898,21792,69652,0,West Midlands,4524,HNL
Henley-On-Thames,208976,309202,88654,606832,0,South East,3146,HOT
Hensall,344,32,0,376,0,Yorkshire and The Humber,8129,HEL
Hereford,258166,536436,322588,1117190,38364,West Midlands,3607,HFD
Herne Bay,114954,277474,309396,701824,0,South East,5174,HNB
Herne Hill,671736,994016,337784,2003536,843160,London,5066,HNH
Hersham,222726,207152,164136,594014,0,South East,5590,HER
Hertford East,344588,441470,114884,900942,0,East of England,6818,HFE
Hertford North,330192,423026,110084,863302,3772,East of England,6085,HFN
Hessle,10128,28904,6454,45486,0,Yorkshire and The Humber,8067,HES
Heswall,16044,37548,6590,60182,0,North West,2138,HSW
Hever,8984,23488,6730,39202,0,South East,5417,HEV
Heworth,13854,11512,3782,29148,0,North East,7766,HEW
Hexham,72566,231754,31810,336130,3846,North East,7506,HEX
Heyford,6242,20504,4666,31412,0,South East,3194,HYD
Heysham Port,700,8748,0,9448,0,North West,2691,HHB
High Brooms,247268,433440,242940,923648,0,South East,5235,HIB
High Street (Glasgow),183808,318894,51214,553916,0,Scotland,9909,HST
High Wycombe,849290,786476,281504,1917270,91589,South East,3054,HWY
Higham,42426,34556,30860,107842,0,South East,5202,HGM
Highams Park,860040,1180972,217838,2258850,0,London,6919,HIP
Highbridge and Burnham,77408,138166,16646,232220,0,South West,3314,HIG
Highbury and Islington,6030530,11874372,2696194,20601096,6839511,London,6009,HHY
Hightown,65884,161742,38946,266572,0,North West,2356,HTO
Hildenborough,102604,107022,84566,294192,0,South East,5236,HLB
Hillfoot,61092,108232,13646,182970,0,Scotland,9983,HLF
Hillington East,52988,78874,43924,175786,0,Scotland,9676,HLE
Hillington West,82866,93432,65720,242018,0,Scotland,9630,HLW
Hillside,100428,317104,90310,507842,0,North West,2231,HIL
Hilsea,108152,134396,55526,298074,5306,South East,5539,HLS
Hinchley Wood,83818,80362,52548,216728,0,South East,5591,HYW
Hinckley (Leics),91290,127240,16886,235416,0,East Midlands,1870,HNK
Hindley,79958,81632,41160,202750,26642,North West,2398,HIN
Hinton Admiral,34602,73832,7004,115438,0,South East,5880,HNA
Hitchin,894884,1221534,395836,2512254,77171,East of England,6086,HIT
Hither Green,843230,1155120,441510,2439860,437506,London,5107,HGR
Hockley,261322,220070,288792,770184,0,East of England,6880,HOC
Hollingbourne,12152,19114,15216,46482,0,South East,5141,HBN
Holmes Chapel,72432,83062,20652,176146,0,North West,1221,HCH
Holmwood,20110,19948,12064,52122,0,South East,5308,HLM
Holton Heath,14906,8656,3936,27498,0,South West,5941,HOL
Holyhead,62240,132464,7408,202112,209,Wales,2437,HHD
Holytown,40690,61936,18978,121604,3,Scotland,9738,HLY
Homerton,1240422,2089072,533126,3862620,0,London,6979,HMN
Honeybourne,18862,59516,7390,85768,0,West Midlands,4794,HYB
Honiton,36666,184752,66810,288228,11251,South West,5717,HON
Honley,16068,14276,10540,40884,0,Yorkshire and The Humber,8436,HOY
Honor Oak Park,793218,1311624,204254,2309096,0,London,5418,HPA
Hook,106314,193038,96874,396226,0,South East,5523,HOK
Hooton,337650,195414,96638,629702,98009,North West,2193,HOO
Hope (Derbyshire),25572,47544,3124,76240,0,East Midlands,2828,HOP
Hope (Flintshire),10564,944,6096,17604,0,Wales,2432,HPE
Hopton Heath,620,104,0,724,0,West Midlands,4189,HPT
Horden,23480,69186,6898,99564,0,North East,6604,HRE
Horley,409108,460316,164242,1033666,0,South East,5365,HOR
Hornbeam Park,105224,119578,100924,325726,0,Yorkshire and The Humber,8212,HBP
Hornsey,458598,669134,187158,1314890,0,London,6015,HRN
Horsforth,297860,260452,109620,667932,2567,Yorkshire and The Humber,8499,HRS
Horsham,586816,1021486,485380,2093682,104781,South East,5309,HRH
Horsley,105640,117242,56158,279040,0,South East,5562,HSY
Horton-In-Ribblesdale,3328,16538,46,19912,0,Yorkshire and The Humber,2105,HIR
Horwich Parkway,164950,208118,74260,447328,0,North West,8720,HWI
Hoscar,448,466,0,914,0,North West,2399,HSC
Hough Green,66552,76784,29610,172946,0,North West,2303,HGN
Hounslow,268908,345048,147916,761872,1060,London,5563,HOU
Hove,462336,1020618,283794,1766748,328410,South East,5273,HOV
Hoveton and Wroxham,40152,75528,9124,124804,0,East of England,7327,HXM
How Wood (Hertfordshire),9380,8172,2494,20046,0,East of England,1563,HWW
Howden,22206,64448,7166,93820,0,Yorkshire and The Humber,8071,HOW
Howwood (Renfrewshire),16758,29706,9256,55720,0,Scotland,1734,HOZ
Hoxton,961448,1960882,331432,3253762,0,London,1023,HOX
Hoylake,134006,199422,84766,418194,0,North West,2194,HYK
Hubberts Bridge,470,426,0,896,0,East Midlands,6221,HBB
Hucknall,81882,25830,12904,120616,0,East Midlands,1862,HKN
Huddersfield,1114946,1461262,444422,3020630,456190,Yorkshire and The Humber,8437,HUD
Hull,146530,2103818,133094,2383442,71382,Yorkshire and The Humber,8126,HUL
Humphrey Park,11498,3994,3722,19214,0,North West,2937,HUP
Huncoat,7798,10612,5834,24244,0,North West,2558,HCT
Hungerford,47320,140360,42142,229822,0,South East,3072,HGD
Hunmanby,7216,26330,7068,40614,0,Yorkshire and The Humber,8098,HUB
Huntingdon,338952,784998,178210,1302160,9,East of England,6108,HUN
Huntly,24268,22974,2326,49568,0,Scotland,8921,HNT
Hunts Cross,256228,783510,267812,1307550,10359,North West,2235,HNX
Hurst Green,115766,147170,182688,445624,38850,South East,5463,HUR
Hutton Cranswick,6492,20574,9302,36368,0,Yorkshire and The Humber,8099,HUT
Huyton,176662,245290,113306,535258,18684,North West,2160,HUY
Hyde Central,32064,18008,10462,60534,0,North West,2829,HYC
Hyde North,15624,5674,6646,27944,0,North West,2959,HYT
Hykeham,78300,25500,9418,113218,0,East Midlands,6310,HKM
Hyndland,307586,589736,125820,1023142,699086,Scotland,9845,HYN
Hythe (Essex),62678,168226,34766,265670,0,East of England,6851,HYH
Ifield,67560,96050,68550,232160,0,South East,5495,IFI
Ilford,2620714,4792410,1337438,8750562,80,London,6881,IFD
Ilkeston,78800,43454,5258,127512,0,East Midlands,7783,ILN
Ilkley,378776,364714,375210,1118700,0,Yorkshire and The Humber,8568,ILK
Imperial Wharf,945076,1201314,560540,2706930,0,London,9586,IMW
Ince (Manchester),10914,7086,5720,23720,0,North West,2236,INC
Ince and Elton (Cheshire),124,6,0,130,0,North West,2122,INE
Ingatestone,255942,132988,293860,682790,0,East of England,6882,INT
Insch,28016,20024,4308,52348,0,Scotland,8922,INS
Invergordon,15444,2318,996,18758,0,Scotland,8648,IGD
Invergowrie,8180,1742,414,10336,0,Scotland,8778,ING
Inverkeithing,241984,459378,44876,746238,32181,Scotland,9136,INK
Inverkip,17354,34174,6162,57690,0,Scotland,9646,INP
Inverness,312292,647990,14526,974808,38939,Scotland,8649,INV
Inverness Airport,3782,2134,180,6096,0,Scotland,455,IVA
Invershin,160,72,0,232,0,Scotland,8614,INH
Inverurie,119190,133494,35672,288356,0,Scotland,8924,INR
Ipswich,549326,1742224,391024,2682574,588347,East of England,7217,IPS
Irlam,105432,68968,55640,230040,0,North West,2817,IRL
Irvine,155638,337152,57740,550530,0,Scotland,9508,IRV
Isleworth,268100,284998,227206,780304,0,London,5592,ISL
Islip,8538,12336,5164,26038,0,South East,3110,ISP
Iver,85398,124568,54974,264940,0,South East,3170,IVR
Ivybridge,9102,76842,14956,100900,0,South West,3555,IVY
James Cook University Hospital,12846,20752,3522,37120,0,North East,9507,JCH
Jewellery Quarter,122968,116344,81272,320584,0,West Midlands,1097,JEQ
Johnston (Pembs),3098,3110,0,6208,0,Wales,4081,JOH
Johnstone (Renfrewshire),238914,461716,120806,821436,0,Scotland,9648,JHN
Jordanhill,52762,124040,14750,191552,0,Scotland,9995,JOR
Kearsley (Manchester),20448,16380,11580,48408,0,North West,2605,KSL
Kearsney (Kent),12126,19110,6820,38056,0,South East,5038,KSN
Keighley,409372,607890,273346,1290608,832,Yorkshire and The Humber,8468,KEI
Keith,20420,35118,410,55948,0,Scotland,8925,KEH
Kelvedon,102808,185816,193482,482106,0,East of England,6838,KEL
Kelvindale,9934,25040,10606,45580,0,Scotland,1655,KVD
Kemble,22004,306510,24324,352838,0,South West,3325,KEM
Kempston Hardwick,2152,2164,142,4458,0,East of England,1384,KMH
Kempton Park Racecourse,11622,26760,384,38766,0,South East,5678,KMP
Kemsing,6848,4536,766,12150,0,South East,5079,KMS
Kemsley,58928,38986,55626,153540,0,South East,5205,KML
Kendal,16492,113108,22930,152530,0,North West,1976,KEN
Kenilworth,53694,77918,7520,139132,0,West Midlands,7985,KNW
Kenley,93560,114142,39084,246786,0,London,5419,KLY
Kennett,21018,13206,9558,43782,0,East of England,7011,KNE
Kennishead,20436,52948,7986,81370,0,Scotland,9816,KNS
Kensal Green,273166,594576,105946,973688,0,London,1447,KNL
Kensal Rise,696770,1063768,438024,2198562,0,London,1448,KNR
Kensington Olympia,792144,1144772,344988,2281904,3443,London,3092,KPA
Kent House,269346,308788,93056,671190,0,London,5080,KTH
Kentish Town,675512,978004,338208,1991724,0,London,1553,KTN
Kentish Town West,523272,799282,222814,1545368,0,London,1449,KTW
Kenton,248738,597540,230606,1076884,0,London,1399,KNT
Kents Bank,3824,17130,3984,24938,0,North West,1966,KBK
Kettering,131774,691588,184538,1007900,369017,East Midlands,1857,KET
Kew Bridge,342284,430412,179728,952424,0,London,5593,KWB
Kew Gardens,350234,762850,109556,1222640,0,London,5594,KWG
Keyham,2952,8338,2240,13530,0,South West,3571,KEY
Keynsham,168320,226210,24056,418586,0,South West,3237,KYN
Kidbrooke,446604,486186,268168,1200958,0,London,5108,KDB
Kidderminster,218080,366910,330896,915886,0,West Midlands,4581,KID
Kidsgrove,82128,127774,14484,224386,16881,West Midlands,1229,KDG
Kidwelly,13000,5490,2482,20972,0,Wales,4132,KWL
Kilburn High Road,136378,411828,94110,642316,0,London,1415,KBN
Kildale,110,1262,0,1372,0,Yorkshire and The Humber,7516,KLD
Kildonan,128,20,0,148,0,Scotland,8652,KIL
Kilgetty,8766,3586,0,12352,0,Wales,4083,KGT
Kilmarnock,117886,220432,17096,355414,5383,Scotland,9512,KMK
Kilmaurs,19732,34154,4416,58302,0,Scotland,9516,KLM
Kilpatrick,18680,36856,10896,66432,0,Scotland,9960,KPT
Kilwinning,187556,332382,71224,591162,60903,Scotland,9517,KWN
Kinbrace,300,136,0,436,0,Scotland,8653,KBC
Kingham,27040,166772,12458,206270,0,South East,3008,KGM
Kinghorn,27660,37344,4612,69616,0,Scotland,9142,KGH
Kings Langley,156482,173720,52038,382240,0,East of England,1392,KGL
Kings Lynn,159618,537382,60034,757034,747,East of England,7115,KLN
Kings Norton,230200,270606,174962,675768,0,West Midlands,1109,KNN
Kings Nympton,900,1492,1516,3908,0,South West,5823,KGN
Kings Park,38984,91280,16834,147098,0,Scotland,9817,KGP
Kings Sutton,20304,27988,6290,54582,0,East Midlands,4508,KGS
Kingsknowe,11660,8414,230,20304,0,Scotland,9217,KGE
Kingston,1188024,2031808,424078,3643910,0,London,5565,KNG
Kingswood,58170,56338,20166,134674,0,South East,5366,KND
Kingussie,16424,16456,98,32978,0,Scotland,8655,KIN
Kintbury,11490,40690,13014,65194,0,South East,3073,KIT
Kintore,37730,42008,5610,85348,0,Scotland,6597,KTR
Kirby Cross,12040,19844,17024,48908,0,East of England,6862,KBX
Kirk Sandall,16222,22304,10824,49350,0,Yorkshire and The Humber,6527,KKS
Kirkby (Merseyside),242862,1336768,481344,2060974,14106,North West,2124,KIR
Kirkby Stephen,4456,25346,86,29888,0,North West,2057,KSW
Kirkby-in-Ashfield,64408,33524,8454,106386,0,East Midlands,1867,KKB
Kirkby-In-Furness,3936,10516,1252,15704,0,North West,1959,KBF
Kirkcaldy,189818,421378,31046,642242,2124,Scotland,9145,KDY
Kirkconnel,3838,9998,118,13954,0,Scotland,9518,KRK
Kirkdale,271602,510110,252074,1033786,125710,North West,2245,KKD
Kirkham and Wesham,65560,222312,27014,314886,22264,North West,2668,KKM
Kirkhill,17186,37422,3520,58128,0,Scotland,9771,KKH
Kirknewton,20586,18380,784,39750,0,Scotland,9230,KKN
Kirkstall Forge,121254,73544,55150,249948,0,Yorkshire and The Humber,6544,KLF
Kirkwood,30110,53896,10062,94068,0,Scotland,9766,KWD
Kirton Lindsey,24,70,0,94,0,Yorkshire and The Humber,6466,KTL
Kiveton Bridge,23562,23238,6714,53514,0,Yorkshire and The Humber,6401,KIV
Kiveton Park,15232,19934,5508,40674,0,Yorkshire and The Humber,6565,KVP
Knaresborough,96574,313082,54068,463724,0,Yorkshire and The Humber,8214,KNA
Knebworth,171388,164236,67880,403504,0,East of England,6088,KBW
Knighton,8084,5318,180,13582,0,West Midlands,4206,KNI
Knockholt,60768,54466,22060,137294,0,London,5109,KCK
Knottingley,81296,46810,22316,150422,0,Yorkshire and The Humber,8546,KNO
Knucklas,1774,856,4,2634,0,Wales,4228,KNU
Knutsford,101392,123214,97356,321962,0,North West,2848,KNF
Kyle Of Lochalsh,22224,24410,0,46634,0,Scotland,8657,KYL
Ladybank,25360,29994,2636,57990,3612,Scotland,9149,LDY
Ladywell,293132,463010,161486,917628,0,London,5057,LAD
Laindon,834586,515292,398634,1748512,0,East of England,7445,LAI
Lairg,2176,1172,0,3348,0,Scotland,8658,LRG
Lake,4354,12918,3728,21000,0,South East,5504,LKE
Lakenheath,294,266,2,562,0,East of England,7201,LAK
Lamphey,2804,1016,0,3820,0,Wales,4084,LAM
Lanark,72640,116026,14524,203190,0,Scotland,9710,LNK
Lancaster,164442,1471388,194240,1830070,381715,North West,2685,LAN
Lancing,229576,423232,167146,819954,0,South East,5275,LAC
Landywood,40900,54730,22000,117630,0,West Midlands,1017,LAW
Langbank,13446,30788,15114,59348,0,Scotland,9652,LGB
Langho,8234,25666,5750,39650,0,North West,2735,LHO
Langley (Berks),254190,364684,150408,769282,0,South East,3171,LNY
Langley Green,36926,46856,37548,121330,0,West Midlands,4607,LGG
Langley Mill,51712,23394,4952,80058,0,East Midlands,1761,LGM
Langside,40886,70784,29300,140970,0,Scotland,9818,LGS
Langwathby,2194,14342,176,16712,0,North West,2058,LGW
Langwith-Whaley Thorns,5894,3184,666,9744,0,East Midlands,1871,LAG
Lapford,2534,2080,1612,6226,0,South West,5824,LAP
Lapworth,9224,7256,60528,77008,0,West Midlands,4595,LPW
Larbert,210638,338482,52444,601564,0,Scotland,9876,LBT
Largs,81740,211264,13032,306036,0,Scotland,9521,LAR
Larkhall,67172,110126,27650,204948,0,Scotland,9728,LRH
Laurencekirk,25724,29362,5584,60670,0,Scotland,8931,LAU
Lawrence Hill,142094,44184,22744,209022,0,South West,3225,LWH
Layton (Lancs),13346,41888,8160,63394,0,North West,2669,LAY
Lazonby and Kirkoswald,1876,9982,1448,13306,0,North West,2059,LZB
Lea Bridge,217640,277614,121990,617244,0,London,6927,LEB
Lea Green,95304,202146,42426,339876,0,North West,2339,LEG
Lea Hall,114754,136804,86544,338102,0,West Midlands,1133,LEH
Leagrave,284630,830142,265636,1380408,0,East of England,1534,LEA
Lealholm,342,2924,4744,8010,0,Yorkshire and The Humber,7925,LHM
Leamington Spa,786104,1116734,187898,2090736,162710,West Midlands,4597,LMS
Leasowe,187506,202500,111478,501484,0,North West,2237,LSW
Leatherhead,485654,459620,239268,1184542,15946,South East,5368,LHD
Ledbury,55418,101368,31174,187960,87,West Midlands,4784,LED
Lee (London),410378,533770,242706,1186854,0,London,5110,LEE
Leeds,5848344,15710712,2405100,23964156,2488509,Yorkshire and The Humber,8487,LDS
Leicester,870426,3658734,340676,4869836,422690,East Midlands,1947,LEI
Leigh (Kent),10220,13402,9688,33310,0,South East,5294,LIH
Leigh-On-Sea,707884,570836,284640,1563360,0,East of England,7446,LES
Leighton Buzzard,297776,573910,270902,1142588,0,East of England,1373,LBZ
Lelant,0,25160,0,25160,0,South West,3539,LEL
Lelant Saltings,0,652,0,652,0,South West,3498,LTS
Lenham,28542,33772,39330,101644,0,South East,5111,LEN
Lenzie,165020,312216,85608,562844,0,Scotland,9955,LNZ
Leominster,86078,105890,53362,245330,0,West Midlands,3620,LEO
Letchworth Garden City,563808,674168,233028,1471004,0,East of England,6089,LET
Leuchars (For St. Andrews),107520,350558,3126,461204,0,Scotland,9188,LEU
Levenshulme,175486,159800,72660,407946,0,North West,2862,LVM
Lewes,447710,1194238,532490,2174438,412266,South East,5329,LWS
Lewisham,1744410,2657292,1516794,5918496,2154284,London,5051,LEW
Leyland,84734,218528,30004,333266,0,North West,2710,LEY
Leyton Midland Road,384518,542556,266306,1193380,0,London,7402,LEM
Leytonstone High Road,262528,406742,171822,841092,0,London,7403,LER
Lichfield City,224458,244258,164576,633292,0,West Midlands,1177,LIC
Lichfield Trent Valley,81238,401812,205228,688278,65725,West Midlands,1291,LTV
Lidlington,756,5998,4788,11542,0,East of England,1579,LID
Limehouse,1064186,866792,508572,2439550,0,London,7491,LHS
Lincoln,470034,1283200,80696,1833930,15497,East Midlands,6340,LCN
Lingfield,86964,123786,142566,353316,0,South East,5369,LFD
Lingwood,15612,21142,7476,44230,0,East of England,7305,LGD
Linlithgow,308646,442794,46072,797512,0,Scotland,9438,LIN
Liphook,91478,170548,263390,525416,0,South East,5634,LIP
Liskeard,21998,239614,48546,310158,59301,South West,3573,LSK
Liss,39304,105738,122724,267766,0,South East,5635,LIS
Lisvane and Thornhill,114848,8876,19534,143258,0,Wales,3853,LVT
Little Kimble,5252,2112,2532,9896,0,South East,3066,LTK
Little Sutton,68274,65274,17206,150754,0,North West,2156,LTT
Littleborough,87454,146306,73194,306954,0,North West,2661,LTL
Littlehampton,144218,423214,243316,810748,4149,South East,5260,LIT
Littlehaven,93728,97950,35410,227088,0,South East,5498,LVN
Littleport,53726,92526,40500,186752,0,East of England,7072,LTP
Liverpool Central,3352230,6520224,1529526,11401980,536662,North West,2242,LVC
Liverpool James Street,705732,1372678,322006,2400416,0,North West,2244,LVJ
Liverpool Lime Street,3264014,6348640,1489276,11101930,861556,North West,2246,LIV
Liverpool South Parkway,331186,1136050,345394,1812630,141083,North West,9709,LPY
Livingston North,309846,437726,60722,808294,0,Scotland,9371,LSN
Livingston South,84880,107954,12808,205642,0,Scotland,9372,LVG
Llanaber,1230,510,10,1750,0,Wales,4327,LLA
Llanbedr,7096,2686,0,9782,0,Wales,4356,LBR
Llanbister Road,330,262,0,592,0,Wales,4226,LLT
Llanbradach,40028,1790,8106,49924,0,Wales,4018,LNB
Llandaf,241230,16850,58454,316534,0,Wales,3844,LLN
Llandanwg,3022,828,10,3860,0,Wales,4460,LDN
Llandecwyn,660,234,116,1010,0,Wales,4334,LLC
Llandeilo,6296,4782,0,11078,0,Wales,4248,LLL
Llandovery,6018,3538,32,9588,0,Wales,4059,LLV
Llandrindod,11220,12230,154,23604,0,Wales,4227,LLO
Llandudno,144820,161124,16512,322456,0,Wales,2484,LLD
Llandudno Junction,120170,158152,18214,296536,113860,Wales,2485,LLJ
Llandybie,3098,1624,48,4770,0,Wales,4247,LLI
Llanelli,158754,74376,40606,273736,3560,Wales,4133,LLE
Llanfairfechan,14782,11772,1408,27962,0,Wales,2488,LLF
Llanfairpwll,11438,10530,1408,23376,0,Wales,2467,LPG
Llangadog,2194,1128,292,3614,0,Wales,4060,LLG
Llangammarch,674,332,0,1006,0,Wales,4162,LLM
Llangennech,1298,560,10,1868,0,Wales,4138,LLH
Llangynllo,362,322,0,684,0,Wales,4207,LGO
Llanharan,64616,23690,17780,106086,0,Wales,9925,LLR
Llanhilleth,53850,3596,9064,66510,0,Wales,9916,LTH
Llanishen,113874,8068,28776,150718,0,Wales,3847,LLS
Llanrwst,8634,5662,324,14620,0,Wales,2457,LWR
Llansamlet,18912,3498,0,22410,0,Wales,4223,LAS
Llantwit Major,135664,40662,36796,213122,0,Wales,9699,LWM
Llanwrda,522,414,0,936,0,Wales,4061,LNR
Llanwrtyd,2110,1882,0,3992,0,Wales,4163,LNW
Llwyngwril,11828,4604,13312,29744,0,Wales,4421,LLW
Llwynypia,31980,1204,5582,38766,0,Wales,3852,LLY
Loch Awe,2828,1210,4356,8394,0,Scotland,8712,LHA
Loch Eil Outward Bound,1484,404,0,1888,0,Scotland,8846,LHE
Lochailort,776,444,0,1220,0,Scotland,8829,LCL
Locheilside,218,244,0,462,0,Scotland,8830,LCS
Lochgelly,16828,21714,2634,41176,0,Scotland,9156,LCG
Lochluichart,106,76,0,182,0,Scotland,8660,LCC
Lochwinnoch,29974,53222,33746,116942,0,Scotland,9655,LHW
Lockerbie,10202,100158,600,110960,0,Scotland,9614,LOC
Lockwood,13526,13612,8874,36012,0,Yorkshire and The Humber,8443,LCK
London Blackfriars,4220946,6882672,1801374,12904992,7722022,London,5112,BFR
London Bridge,14965530,24000950,8690784,47657264,14058086,London,5148,LBG
London Cannon Street,3194148,1953826,1575242,6723216,374906,London,5142,CST
London Charing Cross,4738244,9019646,2433306,16191196,418776,London,5143,CHX
London Euston,3176058,26106360,2035990,31318408,2124018,London,1444,EUS
London Fenchurch Street,4924236,3413316,1870082,10207634,1130771,London,7490,FST
London Fields,467010,768242,137452,1372704,0,London,6966,LOF
London Kings Cross,589830,21621950,1075634,23287414,1694039,London,6121,KGX
London Liverpool Street,28442452,40814678,11191064,80448194,5663454,London,6965,LST
London Marylebone,2815434,6238110,1254248,10307792,742400,London,1475,MYB
London Paddington,15649984,37973390,5559552,59182926,3708113,London,3087,PAD
London Road (Brighton),96160,164372,25392,285924,0,South East,5281,LRB
London Road (Guildford),243092,377344,100134,720570,0,South East,5632,LRD
London St Pancras International,7076286,21297758,4922076,33296120,5673269,London,1555,STP
London Victoria,13813592,24654026,7096354,45563972,3267934,London,5426,VIC
London Waterloo,19253404,29675988,8860388,57789780,4664322,London,5598,WAT
London Waterloo East,1650500,2808390,970994,5429884,640797,London,5158,WAE
Long Buckby,50262,171142,28642,250046,0,East Midlands,1067,LBK
Long Eaton,288670,151914,34204,474788,7527,East Midlands,1829,LGE
Long Preston,3354,10282,406,14042,243,Yorkshire and The Humber,2657,LPR
Longbeck,11594,26662,5682,43938,0,North East,7978,LGK
Longbridge,215010,287074,183592,685676,0,West Midlands,1110,LOB
Longcross,60352,31886,4060,96298,0,South East,5674,LNG
Longfield,112518,160884,96752,370154,0,South East,5114,LGF
Longniddry,64358,67290,6700,138348,0,Scotland,9354,LND
Longport,35658,13212,9178,58048,0,West Midlands,1305,LPT
Longton,32694,17978,4646,55318,0,West Midlands,1306,LGN
Looe,4622,108028,2610,115260,0,South West,3574,LOO
Lostock,87876,51594,37826,177296,0,North West,2598,LOT
Lostock Gralam,14890,16986,22232,54108,0,North West,2307,LTG
Lostock Hall,6758,15138,3538,25434,0,North West,2689,LOH
Lostwithiel,8548,48990,14818,72356,0,South West,3517,LOS
Loughborough,304198,819430,103494,1227122,13513,East Midlands,1897,LBO
Loughborough Junction,331996,458152,161922,952070,0,London,5082,LGJ
Low Moor,80216,93616,25586,199418,0,Yorkshire and The Humber,8416,LMR
Lowdham,30136,7260,2592,39988,0,East Midlands,6202,LOW
Lower Sydenham,203130,276284,82758,562172,0,London,5053,LSY
Lowestoft,94588,274446,27584,396618,9046,East of England,7268,LWT
Ludlow,83670,112280,39008,234958,822,West Midlands,3635,LUD
Luton,587300,2320676,374156,3282132,51288,East of England,1536,LUT
Luton Airport Parkway,1697288,1946978,123524,3767790,5783,East of England,3645,LTN
Luxulyan,442,2080,0,2522,0,South West,3518,LUX
Lydney,87740,42704,14544,144988,0,South West,4826,LYD
Lye (West Midlands),15734,22722,23732,62188,0,West Midlands,4640,LYE
Lymington Pier,14930,59716,6034,80680,0,South East,5892,LYP
Lymington Town,44230,144766,24648,213644,0,South East,5887,LYT
Lympstone Commando,21926,61200,34,83160,0,South West,5762,LYC
Lympstone Village,41676,33830,7536,83042,0,South West,5761,LYM
Lytham,17040,92280,3332,112652,0,North West,2670,LTM
Macclesfield,177410,957042,49332,1183784,7693,North West,2871,MAC
Machynlleth,53442,44626,2070,100138,10738,Wales,4422,MCN
Maesteg,107036,7812,27438,142286,0,Wales,3963,MST
Maesteg (Ewenny Road),13706,1094,308,15108,0,Wales,3962,MEW
Maghull,203566,753560,207868,1164994,0,North West,2155,MAG
Maghull North,142690,317728,85010,545428,0,North West,6576,MNS
Maiden Newton,6272,12988,306,19566,0,South West,5853,MDN
Maidenhead,1014424,1635694,589756,3239874,421152,South East,3147,MAI
Maidstone Barracks,56136,94948,55114,206198,135921,South East,5237,MDB
Maidstone East,281744,476544,276614,1034902,35260,South East,5115,MDE
Maidstone West,174906,295838,171722,642466,132606,South East,5222,MDW
Malden Manor,151712,153230,73588,378530,0,London,5599,MAL
Mallaig,19250,52442,0,71692,0,Scotland,8831,MLG
Malton,80012,123794,48998,252804,0,Yorkshire and The Humber,8164,MLT
Malvern Link,118910,114850,68368,302128,14259,West Midlands,4884,MVL
Manchester Airport,679898,3121056,115978,3916932,16945,North West,2961,MIA
Manchester Oxford Road,955418,3320564,381954,4657936,815640,North West,2966,MCO
Manchester Piccadilly,4832196,16794362,1931806,23558364,2046226,North West,2968,MAN
Manchester Victoria,1436334,4991996,574214,7002544,865986,North West,2970,MCV
Manea,12940,6504,1594,21038,0,East of England,7165,MNE
Manningtree,155882,438332,188916,783130,260705,East of England,6856,MNG
Manor Park,1080976,1943014,695694,3719684,0,London,6883,MNP
Manor Road,72726,127232,40762,240720,0,North West,2253,MNR
Manorbier,4614,2332,0,6946,0,Wales,4094,MRB
Manors,6224,11300,1416,18940,0,North East,7603,MAS
Mansfield,152530,132990,17022,302542,0,East Midlands,1727,MFT
Mansfield Woodhouse,62410,42496,6570,111476,0,East Midlands,1728,MSW
March,99588,143292,62474,305354,27,East of England,7166,MCH
Marden (Kent),85162,179818,142484,407464,0,South East,5223,MRN
Margate,129026,774952,121962,1025940,8333,South East,5018,MAR
Market Harborough,104464,541058,117270,762792,0,East Midlands,1909,MHR
Market Rasen,14870,40300,810,55980,0,East Midlands,6318,MKR
Markinch,65978,117366,4048,187392,0,Scotland,9160,MNC
Marks Tey,117926,146112,137912,401950,275482,East of England,6863,MKT
Marlow,81758,129776,43844,255378,0,South East,3021,MLW
Marple,141244,98396,66664,306304,0,North West,2830,MPL
Marsden (Yorks),94234,75096,14536,183866,0,Yorkshire and The Humber,8445,MSN
Marske,11152,33248,5650,50050,0,North East,7928,MSK
Marston Green,166542,260272,148710,575524,0,West Midlands,1034,MGN
Martin Mill,7478,21688,16728,45894,0,South East,5040,MTM
Martins Heron,122392,173708,50116,346216,0,South East,5692,MAO
Marton,6412,14480,1286,22178,0,North East,7947,MTO
Maryhill,19002,32362,8866,60230,0,Scotland,9957,MYH
Maryland,899600,1470492,418054,2788146,0,London,6970,MYL
Maryport,30348,61324,9756,101428,0,North West,1988,MRY
Matlock,44896,123000,6344,174240,0,East Midlands,1581,MAT
Matlock Bath,15186,51974,1306,68466,0,East Midlands,1582,MTB
Mauldeth Road,79476,91230,21454,192160,0,North West,2867,MAU
Maxwell Park,20572,38588,8874,68034,0,Scotland,9802,MAX
Maybole,16508,27194,2342,46044,0,Scotland,9529,MAY
Maze Hill,424790,603926,137216,1165932,0,London,5149,MZH
Meadowhall,427780,859718,165280,1452778,37097,Yorkshire and The Humber,6663,MHS
Meldreth,78912,91066,47180,217158,0,East of England,7036,MEL
Melksham,27260,32586,4360,64206,0,South West,3346,MKM
Melton (Suffolk),18870,45126,3958,67954,0,East of England,7221,MES
Melton Mowbray,69258,123814,12502,205574,0,East Midlands,1851,MMO
Menheniot,806,1946,882,3634,0,South West,3576,MEN
Menston,217826,155410,207738,580974,0,Yorkshire and The Humber,8574,MNN
Meols,134554,164374,38532,337460,0,North West,2254,MEO
Meols Cop,37080,32934,15434,85448,0,North West,2357,MEC
Meopham,70536,83402,61594,215532,0,South East,5116,MEP
Meridian Water,78032,96700,38152,212884,0,London,6599,MRW
Merryton,16418,28486,11346,56250,0,Scotland,9705,MEY
Merstham,219138,259804,129150,608092,0,South East,5475,MHM
Merthyr Tydfil,192766,16876,69772,279414,0,Wales,3855,MER
Merthyr Vale,27556,1250,11900,40706,0,Wales,3857,MEV
Metheringham,39278,14270,15090,68638,0,East Midlands,6297,MGM
MetroCentre,56458,239138,25168,320764,0,North East,7725,MCE
Mexborough,44922,49810,27120,121852,0,Yorkshire and The Humber,6707,MEX
Micheldever,14424,56436,22638,93498,0,South East,5908,MIC
Micklefield,63666,68290,41716,173672,1733,Yorkshire and The Humber,8477,MIK
Middlesbrough,238400,1008352,129658,1376410,48167,North East,7929,MBR
Middlewood,5340,9134,4284,18758,0,North West,2971,MDL
Midgham,5682,22282,4476,32440,0,South East,3159,MDG
Milford (Surrey),69060,66470,37406,172936,0,South East,5644,MLF
Milford Haven,22266,23522,370,46158,0,Wales,4095,MFH
Mill Hill (Lancs),17246,33840,8738,59824,0,North West,2750,MLH
Mill Hill Broadway,591426,745324,249776,1586526,0,London,1527,MIL
Millbrook (Bedfordshire),1004,3058,2504,6566,0,East of England,1537,MLB
Millbrook (Hants),7564,12996,4866,25426,0,South East,5909,MBK
Milliken Park,43588,83624,33902,161114,0,Scotland,9658,MIN
Millom,43770,93376,30356,167502,0,North West,1997,MLM
Mills Hill (Manchester),109148,88444,44796,242388,0,North West,2920,MIH
Milngavie,189156,317744,42166,549066,0,Scotland,9985,MLN
Milton Keynes Central,713090,3318560,477934,4509584,189748,South East,1378,MKC
Minffordd,4610,1222,9100,14932,0,Wales,4469,MFF
Minster,19720,27548,19338,66606,2031,South East,5019,MSR
Mirfield,123962,209150,42100,375212,20168,Yorkshire and The Humber,8518,MIR
Mistley,10748,19156,18054,47958,0,East of England,6906,MIS
Mitcham Eastfields,344202,398384,327658,1070244,0,London,5069,MTC
Mitcham Junction,122758,145708,81962,350428,0,London,5427,MIJ
Mobberley,5956,6836,3898,16690,0,North West,2849,MOB
Monifieth,17114,6888,366,24368,0,Scotland,9060,MON
Monks Risborough,6000,3200,5786,14986,0,South East,3067,MRS
Montpelier,117166,42216,10158,169540,0,South West,3203,MTP
Montrose,77932,151642,14222,243796,0,Scotland,9080,MTS
Moorfields,1499682,2916942,684262,5100886,531546,North West,2226,MRF
Moorgate,2026610,2909302,651804,5587716,672934,London,6005,MOG
Moorside,13994,10012,6892,30898,0,North West,2799,MSD
Moorthorpe,83358,43186,33258,159802,0,Yorkshire and The Humber,8539,MRP
Morar,1738,1466,0,3204,0,Scotland,8833,MRR
Morchard Road,6694,6946,3474,17114,0,South West,5825,MRD
Morden South,20618,25682,14638,60938,0,London,5291,MDS
Morecambe,29078,118424,17806,165308,0,North West,2695,MCM
Moreton (Dorset),12132,53050,2826,68008,0,South West,5957,MTN
Moreton (Merseyside),175912,194552,98754,469218,0,North West,2151,MRT
Moreton-In-Marsh,41694,219116,8262,269072,0,South West,4814,MIM
Morfa Mawddach,6058,2064,52,8174,0,Wales,4470,MFA
Morley,136668,148770,41510,326948,0,Yorkshire and The Humber,8504,MLY
Morpeth,83306,389616,14688,487610,1648,North East,7680,MPT
Mortimer,31472,72284,17246,121002,0,South East,5501,MOR
Mortlake,496386,557306,199328,1253020,0,London,5600,MTL
Moses Gate,16158,8410,6350,30918,0,North West,2606,MSS
Moss Side,926,2396,94,3416,0,North West,2675,MOS
Mossley (Manchester),92586,57960,48542,199088,0,North West,2903,MSL
Mossley Hill,67296,64766,33988,166050,0,North West,2171,MSH
Mosspark,27400,70044,9094,106538,0,Scotland,9632,MPK
Moston,28148,22408,11218,61774,0,North West,2973,MSO
Motherwell,242378,386498,70344,699220,72468,Scotland,9691,MTH
Motspur Park,266534,337336,140736,744606,6835,London,5645,MOT
Mottingham,380304,459144,210472,1049920,0,London,5118,MTG
Mottisfont and Dunbridge,4834,14274,5304,24412,0,South East,5944,DBG
Mouldsworth,8872,13188,3652,25712,0,North West,2158,MLD
Moulsecoomb,103486,175244,40956,319686,0,South East,5312,MCB
Mount Florida,276768,594662,67448,938878,3781,Scotland,9819,MFL
Mount Vernon,17072,24736,2350,44158,0,Scotland,9779,MTV
Mountain Ash,64912,3166,10190,78268,0,Wales,3859,MTA
Muir Of Ord,37868,7462,2358,47688,0,Scotland,8665,MOO
Muirend,81490,144422,17672,243584,0,Scotland,9608,MUI
Musselburgh,193456,139382,17432,350270,0,Scotland,9304,MUB
Mytholmroyd,71008,52186,34050,157244,0,Yorkshire and The Humber,8526,MYT
Nafferton,6538,21580,3852,31970,0,Yorkshire and The Humber,8107,NFN
Nailsea and Backwell,138558,178798,97094,414450,0,South West,3389,NLS
Nairn,23474,72812,5356,101642,0,Scotland,8666,NRN
Nantwich,114438,57892,13360,185690,0,North West,1247,NAN
Narberth,9286,4112,70,13468,0,Wales,4098,NAR
Narborough,94018,60852,52722,207592,0,East Midlands,1881,NBR
Navigation Road,32644,26468,12972,72084,0,North West,2940,NVR
Neath,387352,218460,60246,666058,0,Wales,4216,NTH
Needham Market,43326,37012,13810,94148,0,East of England,7354,NMT
Neilston,49990,100884,155448,306322,0,Scotland,9773,NEI
Nelson,30132,49436,10704,90272,0,North West,2565,NEL
Neston,26678,5446,1118,33242,0,North West,2139,NES
Netherfield,4070,2272,604,6946,0,East Midlands,6241,NET
Nethertown,140,820,0,960,0,North West,2047,NRT
Netley,20970,41284,11550,73804,0,South East,5911,NTL
New Barnet,440650,487838,154788,1083276,0,London,6018,NBA
New Beckenham,227112,267766,50454,545332,0,London,5058,NBC
New Brighton,284248,464204,183356,931808,0,North West,2152,NBN
New Clee,580,602,414,1596,0,Yorkshire and The Humber,6289,NCE
New Cross,814422,1422338,834570,3071330,4608551,London,5150,NWX
New Cross Gate,1043432,2363030,654440,4060902,1351428,London,5345,NXG
New Cumnock,7404,9984,126,17514,0,Scotland,9533,NCK
New Eltham,702302,760678,259008,1721988,0,London,5119,NEH
New Holland,3100,4768,682,8550,0,Yorkshire and The Humber,6209,NHL
New Hythe,45946,29952,52250,128148,0,South East,5238,NHE
New Lane,778,1410,0,2188,0,North West,2358,NLN
New Malden,831032,1272430,459808,2563270,27938,London,5567,NEM
New Mills Central,60090,72616,42744,175450,2507,East Midlands,2974,NMC
New Mills Newtown,41120,48366,45554,135040,0,East Midlands,2769,NMN
New Milton,93380,317140,52092,462612,0,South East,5881,NWM
New Pudsey,264270,218896,74144,557310,0,Yorkshire and The Humber,8506,NPD
New Southgate,323364,279572,93722,696658,0,London,6019,NSG
Newark Castle,83832,391090,32838,507760,66916,East Midlands,6498,NCT
Newark Northgate,146202,682066,57270,885538,152799,East Midlands,6499,NNG
Newbridge,82374,4578,21636,108588,0,Wales,9919,NBE
Newbury,250330,773846,183824,1208000,112293,South East,3074,NBY
Newbury Racecourse,16904,59986,6838,83728,0,South East,3071,NRC
Newcastle,627086,7474300,301536,8402922,306624,North East,7728,NCL
Newcourt,48924,78800,18184,145908,0,South West,9589,NCO
Newcraighall,83174,90448,4182,177804,0,Scotland,8808,NEW
Newhaven Harbour,4312,7276,11588,23176,0,South East,5330,NVH
Newhaven Town,95174,162754,61110,319038,0,South East,5331,NVN
Newington,38604,36174,41290,116068,0,South East,5175,NGT
Newmarket,106328,142910,54094,303332,0,East of England,7038,NMK
Newport (Essex),48782,58172,91380,198334,0,East of England,7039,NWE
Newport (South Wales),1027714,1130560,181292,2339566,478180,Wales,3674,NWP
Newquay,0,128002,1846,129848,0,South West,3523,NQY
Newstead,19258,8132,4312,31702,0,East Midlands,1863,NSD
Newton (Lanark),129124,239744,65432,434300,42750,Scotland,9774,NTN
Newton Abbot,139806,823754,191786,1155346,441021,South West,3426,NTA
Newton Aycliffe,22092,50858,12192,85142,0,North East,7834,NAY
Newton For Hyde,44608,38048,24156,106812,0,North West,2789,NWN
Newton St Cyres,2070,2172,0,4242,0,South West,5828,NTC
Newtongrange,52350,57146,5422,114918,0,Scotland,6929,NEG
Newton-Le-Willows,169010,544236,85280,798526,302820,North West,2257,NLW
Newtonmore,3576,2862,32,6470,0,Scotland,8668,NWR
Newton-On-Ayr,26374,36762,4900,68036,0,Scotland,9571,NOA
Newtown (Powys),78226,35750,10436,124412,0,Wales,4426,NWT
Ninian Park,53306,2006,18274,73586,0,Wales,3895,NNP
Nitshill,34796,50676,11240,96712,0,Scotland,9609,NIT
Norbiton,653754,840966,275844,1770564,0,London,5568,NBT
Norbury,581892,754050,602268,1938210,0,London,5428,NRB
Normans Bay,3986,10120,3748,17854,0,South East,5460,NSB
Normanton,89908,55716,26478,172102,0,Yorkshire and The Humber,8528,NOR
North Berwick,151224,286444,23006,460674,0,Scotland,9358,NBW
North Camp,61512,127458,20442,209412,0,South East,5636,NCM
North Dulwich,240904,265528,95684,602116,0,London,5429,NDL
North Fambridge,21844,11766,14080,47690,0,East of England,6875,NFA
North Llanrwst,1220,1194,0,2414,0,Wales,2455,NLR
North Queensferry,32562,63010,2942,98514,0,Scotland,9189,NQU
North Road (Darlington),11944,28272,7006,47222,0,North East,7895,NRD
North Sheen,114650,109184,45904,269738,0,London,5601,NSH
North Walsham,74482,136196,32530,243208,0,East of England,7308,NWA
North Wembley,263364,538556,140718,942638,0,London,1422,NWB
Northallerton,47834,540954,31194,619982,0,Yorkshire and The Humber,7996,NTR
Northampton,340916,1771788,294524,2407228,946,East Midlands,1069,NMP
Northfield,158094,193904,137212,489210,0,West Midlands,1111,NFD
Northfleet,64126,59292,33472,156890,0,South East,5120,NFL
Northolt Park,62874,71738,16058,150670,0,London,1478,NLT
Northumberland Park,187852,440514,158376,786742,0,London,6971,NUM
Northwich,55292,79756,15550,150598,0,North West,2326,NWI
Norwich,565648,3173234,225066,3963948,437360,East of England,7309,NRW
Norwood Junction,1227506,1938616,640358,3806480,1158598,London,5376,NWD
Nottingham,1390732,5067020,281806,6739558,404203,East Midlands,1826,NOT
Nuneaton,363090,531630,65660,960380,498736,West Midlands,1077,NUN
Nunhead,298668,386526,155262,840456,0,London,5068,NHD
Nunthorpe,11744,28118,2444,42306,0,North East,7946,NNT
Nutbourne,15212,21116,27224,63552,0,South East,5262,NUT
Nutfield,20072,20738,15644,56454,0,South East,5476,NUF
Oakengates,15232,31154,7634,54020,0,West Midlands,4689,OKN
Oakham,41554,120410,10212,172176,3345,East Midlands,1904,OKM
Oakleigh Park,339150,311104,83508,733762,0,London,6020,OKL
Oban,52766,73586,59786,186138,0,Scotland,8725,OBN
Ockendon,392562,348110,160678,901350,0,East of England,7451,OCK
Ockley,14004,11332,3760,29096,0,South East,5310,OLY
Okehampton,141318,61496,25458,228272,0,South West,5786,OKE
Old Hill,37392,46682,24280,108354,0,West Midlands,4641,OHL
Old Roan,138770,565340,143616,847726,0,North West,2258,ORN
Old Street,2091660,2894364,451148,5437172,0,London,6003,OLD
Oldfield Park,126596,134920,36294,297810,0,South West,3219,OLF
Olton,119970,152476,70056,342502,0,West Midlands,4533,OLT
Ore,65276,81156,82130,228562,0,South East,5021,ORE
Ormskirk,377308,1151204,292004,1820516,23139,North West,2281,OMS
Orpington,1354162,1970482,705758,4030402,578762,London,5122,ORP
Orrell,31958,20950,20198,73106,0,North West,2259,ORR
Orrell Park,295570,484948,272468,1052986,0,North West,2247,OPK
Otford,115084,137694,73638,326416,25191,South East,5071,OTF
Oulton Broad North,30052,74268,4850,109170,0,East of England,7273,OUN
Oulton Broad South,15818,34610,782,51210,0,East of England,7274,OUS
Outwood,134304,69810,38158,242272,0,Yorkshire and The Humber,8309,OUT
Overpool,70844,104492,16776,192112,0,North West,2157,OVE
Overton,21776,70384,29400,121560,0,South East,5526,OVR
Oxenholme Lake District,0,474086,7542,481628,353601,North West,2090,OXN
Oxford,708372,5320080,553154,6581606,514180,South East,3115,OXF
Oxford Parkway,83542,472696,28692,584930,0,South East,3121,OXP
Oxshott,130522,138454,75640,344616,0,South East,5602,OXS
Oxted,285762,402774,439122,1127658,0,South East,5377,OXT
Paddock Wood,235710,355562,289920,881192,110489,South East,5224,PDW
Padgate,52130,42638,9696,104464,0,North West,2387,PDG
Paignton,67624,478362,90414,636400,3,South West,3427,PGN
Paisley Canal,77664,123456,63600,264720,0,Scotland,9657,PCN
Paisley Gilmour Street,779858,1270458,549714,2600030,75085,Scotland,9683,PYG
Paisley St James,22194,36072,6212,64478,0,Scotland,9664,PYJ
Palmers Green,495828,611098,160642,1267568,0,London,6021,PAL
Pangbourne,80774,176598,63998,321370,0,South East,3036,PAN
Pannal,40388,56444,24962,121794,0,Yorkshire and The Humber,8479,PNL
Pantyffynnon,1598,806,0,2404,0,Wales,4250,PTF
Par,25440,141226,28314,194980,106235,South West,3524,PAR
Parbold,31632,47370,19348,98350,0,North West,2402,PBL
Park Street,5750,6566,4526,16842,0,East of England,1561,PKT
Parkstone (Dorset),41072,123440,7566,172078,0,South West,5882,PKS
Parson Street,70084,79222,7730,157036,0,South West,3246,PSN
Partick,536758,1279796,286174,2102728,231440,Scotland,9917,PTK
Parton,2242,4780,1180,8202,0,North West,2032,PRN
Patchway,44046,29814,3916,77776,0,South West,3213,PWY
Patricroft,46072,44410,15046,105528,0,North West,2916,PAT
Patterton,85760,147878,136564,370202,0,Scotland,9775,PTT
Peartree,3968,186,220,4374,0,East Midlands,1687,PEA
Peckham Rye,1679006,2848900,884472,5412378,3039337,London,5423,PMR
Pegswood,1430,100,82,1612,0,North East,7685,PEG
Pemberton,16174,13712,5608,35494,0,North West,2403,PEM
Pembrey and Burry Port,53694,21422,16954,92070,0,Wales,4140,PBY
Pembroke,15542,7888,156,23586,0,Wales,4101,PMB
Pembroke Dock,24970,7842,144,32956,0,Wales,4102,PMD
Penally,3944,1562,124,5630,0,Wales,4129,PNA
Penarth,277002,30888,59608,367498,0,Wales,3863,PEN
Pencoed,99144,29818,23908,152870,0,Wales,3851,PCD
Pengam,145432,7686,36164,189282,0,Wales,4021,PGM
Penge East,360026,524748,151022,1035796,1975,London,5072,PNE
Penge West,197776,342046,68944,608766,0,London,5378,PNW
Penhelig,4066,1984,0,6050,0,Wales,4335,PHG
Penistone,68850,53236,20186,142272,0,Yorkshire and The Humber,6634,PNS
Penkridge,143084,63228,25066,231378,0,West Midlands,1195,PKG
Penmaenmawr,7050,5898,1884,14832,0,Wales,2494,PMW
Penmere,23724,117848,36544,178116,0,South West,3499,PNM
Penrhiwceiber,23986,760,7172,31918,0,Wales,3992,PER
Penrhyndeudraeth,11230,4040,41182,56452,0,Wales,4473,PRH
Penrith (North Lakes),0,421830,69080,490910,114178,North West,2102,PNR
Penryn (Cornwall),31422,191982,34170,257574,0,South West,3525,PYN
Pensarn (Gwynedd),972,432,10,1414,0,Wales,4463,PES
Penshurst,9528,13560,17622,40710,0,South East,5477,PHR
Pentre-Bach,16558,658,2248,19464,0,Wales,3944,PTB
Pen-Y-Bont (Mid Wales),546,458,0,1004,0,Wales,4254,PNY
Penychain,2502,1812,0,4314,0,Wales,4409,PNC
Penyffordd,15874,860,1128,17862,0,Wales,2433,PNF
Penzance,19470,508214,37040,564724,2604,South West,3526,PNZ
Perranwell,7774,20570,3582,31926,0,South West,3528,PRW
Perry Barr,40868,59392,39116,139376,0,West Midlands,1128,PRY
Pershore,27512,63876,12486,103874,0,West Midlands,4887,PSH
Perth,153594,519938,21744,695276,118969,Scotland,8805,PTH
Peterborough,408664,3782632,327720,4519016,773281,East of England,6133,PBO
Petersfield,193526,589112,255100,1037738,7646,South East,5657,PTR
Petts Wood,600678,585716,205372,1391766,0,London,5123,PET
Pevensey and Westham,42390,63236,47308,152934,0,South East,5461,PEV
Pevensey Bay,884,1060,3248,5192,0,South East,5462,PEB
Pewsey,19348,143512,18240,181100,0,South West,3062,PEW
Pilning,150,188,0,338,0,South West,3214,PIL
Pinhoe,27262,103496,35594,166352,0,South West,5757,PIN
Pitlochry,17282,87320,984,105586,0,Scotland,8801,PIT
Pitsea,471102,377598,211378,1060078,199418,East of England,7452,PSE
Pleasington,1910,6072,82,8064,0,North West,2752,PLS
Plockton,6154,2376,0,8530,0,Scotland,8670,PLK
Pluckley,22572,42780,27320,92672,0,South East,5225,PLC
Plumley,4984,8862,944,14790,0,North West,2308,PLM
Plumpton,19264,54266,18466,91996,0,South East,5332,PMP
Plumstead,310516,454948,240500,1005964,0,London,5208,PLU
Plymouth,181586,1972450,159056,2313092,90291,South West,3580,PLY
Pokesdown,89196,201588,19098,309882,0,South West,5885,POK
Polegate,123348,552558,253562,929468,19,South East,5455,PLG
Polesworth,126,12,50,188,0,West Midlands,1078,PSW
Pollokshaws East,61460,90272,36600,188332,0,Scotland,9820,PWE
Pollokshaws West,61310,149862,14164,225336,0,Scotland,9804,PWW
Pollokshields East,77774,158454,19600,255828,0,Scotland,9821,PLE
Pollokshields West,26252,56744,13898,96894,0,Scotland,9623,PLW
Polmont,186560,286072,48490,521122,0,Scotland,9936,PMT
Polsloe Bridge,52750,89686,16822,159258,0,South West,3422,POL
Ponders End,241882,364934,92102,698918,0,London,6819,PON
Pontarddulais,2046,1114,20,3180,0,Wales,4251,PTD
Pontefract Baghill,4118,5060,460,9638,13,Yorkshire and The Humber,8540,PFR
Pontefract Monkhill,104538,74866,18630,198034,4381,Yorkshire and The Humber,8548,PFM
Pontefract Tanshelf,45064,32274,8030,85368,0,Yorkshire and The Humber,8541,POT
Pontlottyn,25158,1194,8566,34918,0,Wales,4023,PLT
Pontyclun,136194,47776,26692,210662,0,Wales,3850,PYC
Pont-y-Pant,430,346,0,776,0,Wales,2459,PYP
Pontypool and New Inn,63086,18238,27718,109042,0,Wales,3744,PPL
Pontypridd,410566,22820,102664,536050,35985,Wales,3904,PPD
Poole,191588,584914,48162,824664,4049,South West,5883,POO
Poppleton,16266,45974,9904,72144,0,Yorkshire and The Humber,8254,POP
Port Glasgow,89094,176820,58050,323964,2534,Scotland,9667,PTG
Port Sunlight,205038,213164,121422,539624,0,North West,2198,PSL
Port Talbot Parkway,270108,157556,44184,471848,0,Wales,4181,PTA
Portchester,85378,179658,30646,295682,0,South East,5928,PTC
Porth,118636,6554,26502,151692,0,Wales,3870,POR
Porthmadog,38430,16878,13716,69024,0,Wales,4313,PTM
Portlethen,22266,18802,7378,48446,0,Scotland,8860,PLN
Portslade,235630,452134,139006,826770,0,South East,5276,PLD
Portsmouth and Southsea,306960,1228862,171388,1707210,21158,South East,5537,PMS
Portsmouth Arms,456,342,0,798,0,South West,5829,PMA
Portsmouth Harbour,314038,1257198,175338,1746574,12920,South East,5540,PMH
Possilpark and Parkhouse,18184,34742,8584,61510,0,Scotland,9958,PPK
Potters Bar,818116,1002906,251732,2072754,0,East of England,6022,PBR
Poulton-Le-Fylde,66706,413270,29904,509880,0,North West,2671,PFY
Poynton,61536,87192,13202,161930,0,North West,2874,PYT
Prees,1826,1692,712,4230,0,West Midlands,1346,PRS
Prescot,79388,93208,62102,234698,0,North West,2337,PSC
Prestatyn,149182,119806,20142,289130,0,Wales,2521,PRT
Prestbury,12534,24592,3816,40942,0,North West,2875,PRB
Preston (Lancs),435352,3568028,233156,4236536,1083436,North West,2753,PRE
Preston Park,270944,450124,122806,843874,0,South East,5285,PRP
Prestonpans,90898,73784,8236,172918,0,Scotland,9366,PST
Prestwick International Airport,41662,13638,1680,56980,0,Scotland,9544,PRA
Prestwick Town,65868,136472,9652,211992,0,Scotland,9543,PTW
Priesthill and Darnley,43730,68222,12102,124054,0,Scotland,9808,PTL
Princes Risborough,221194,151760,89778,462732,28230,South East,3055,PRR
Prittlewell,105704,100060,75514,281278,0,East of England,7419,PRL
Prudhoe,33238,84330,16126,133694,0,North East,7509,PRU
Pulborough,78220,151666,56166,286052,0,South East,5468,PUL
Purfleet,223988,191178,93422,508588,0,East of England,7453,PFL
Purley,788166,1191826,368108,2348100,549392,London,5379,PUR
Purley Oaks,169008,198484,62598,430090,0,London,5430,PUO
Putney,1689486,2332224,1096518,5118228,0,London,5603,PUT
Pwllheli,29152,25776,18404,73332,0,Wales,4314,PWL
Pye Corner,84322,1830,14084,100236,0,Wales,1663,PYE
Pyle,49694,18530,9718,77942,0,Wales,4185,PYL
Quakers Yard,30036,1256,6946,38238,0,Wales,3994,QYD
Queenborough,53740,47178,39252,140170,0,South East,5176,QBR
Queens Park (Glasgow),131080,353094,35166,519340,0,Scotland,9822,QPK
Queens Park (London),1088876,2340486,424332,3853694,0,London,1419,QPW
Queens Road (Peckham),780976,1316672,482050,2579698,0,London,5424,QRP
Queenstown Road (Battersea),308610,365216,179200,853026,0,London,5596,QRB
Quintrell Downs,286,2742,10,3038,0,South West,3531,QUI
Radcliffe (Nottinghamshire),6476,4968,438,11882,0,East Midlands,6242,RDF
Radlett,401084,563172,117294,1081550,0,East of England,1546,RDT
Radley,24566,64520,13046,102132,0,South East,3118,RAD
Radyr,252006,16380,63484,331870,19865,Wales,3874,RDR
Rainford,8432,11648,714,20794,0,North West,2404,RNF
Rainham (Essex),556464,567142,148104,1271710,0,London,7454,RNM
Rainham (Kent),356266,588880,445026,1390172,8960,South East,5177,RAI
Rainhill,67688,64418,30708,162814,0,North West,2296,RNH
Ramsgate,167578,630778,353194,1151550,133508,South East,5023,RAM
Ramsgreave and Wilpshire,20098,58182,26050,104330,0,North West,2734,RGW
Rannoch,3688,2130,0,5818,0,Scotland,8834,RAN
Rauceby,2362,90,2810,5262,0,East Midlands,6361,RAU
Ravenglass for Eskdale,5118,27046,1540,33704,0,North West,1999,RAV
Ravensbourne,96102,78902,25996,201000,0,London,5083,RVB
Ravensthorpe,15132,12978,10214,38324,0,Yorkshire and The Humber,8519,RVN
Rawcliffe,396,46,0,442,0,Yorkshire and The Humber,8031,RWC
Rayleigh,499956,452930,379506,1332392,0,East of England,6884,RLG
Raynes Park,978960,1407364,553530,2939854,72722,London,5569,RAY
Reading,2911936,8045008,1444044,12400988,3730402,South East,3149,RDG
Reading West,120620,130358,38862,289840,13464,South East,3160,RDW
Rectory Road,323176,484922,91648,899746,0,London,6967,REC
Redbridge,9630,12796,6468,28894,1389,South East,5912,RDB
Redcar Central,48824,295558,23042,367424,0,North East,7950,RCC
Redcar East,14700,59766,8416,82882,0,North East,7974,RCE
Reddish North,58106,55212,32914,146232,0,North West,2979,RDN
Reddish South,36,64,0,100,0,North West,2857,RDS
Redditch,245970,333264,106006,685240,0,West Midlands,1208,RDC
Redhill,913322,1401386,396932,2711640,883275,South East,5478,RDH
Redland,104858,45166,8112,158136,0,South West,3247,RDA
Redruth,28406,255566,45018,328990,0,South West,3530,RED
Reedham (London),38606,40218,18640,97464,0,London,5431,RHM
Reedham (Norfolk),10212,18724,8106,37042,903,East of England,7316,REE
Reigate,353754,409888,240966,1004608,0,South East,5480,REI
Renton,14900,28820,9180,52900,0,Scotland,9867,RTN
Reston,640,12544,6,13190,0,Scotland,8634,RSN
Retford,33554,458574,27740,519868,66127,East Midlands,6511,RET
Rhiwbina,49478,3166,7436,60080,0,Wales,3906,RHI
Rhoose Cardiff International Airport,97410,24590,31094,153094,0,Wales,3876,RIA
Rhosneigr,6312,4030,108,10450,0,Wales,2544,RHO
Rhyl,222940,221988,38496,483424,0,Wales,2461,RHL
Rhymney,71244,4976,17304,93524,0,Wales,4027,RHY
Ribblehead,2696,20730,0,23426,0,Yorkshire and The Humber,2106,RHD
Rice Lane,83160,219454,201196,503810,0,North West,2131,RIL
Richmond (London),2499366,4356358,1068902,7924626,1029867,London,5570,RMD
Rickmansworth,389310,551624,42374,983308,0,East of England,687,RIC
Riddlesdown,87170,98552,34802,220524,0,London,5432,RDD
Ridgmont,1946,5818,3806,11570,0,East of England,1538,RID
Riding Mill,6252,14314,3596,24162,0,North East,7510,RDM
Risca and Pontymister,55758,2578,14078,72414,0,Wales,9920,RCA
Rishton,9566,24712,3364,37642,0,North West,2580,RIS
Robertsbridge,37314,96404,92062,225780,0,South East,5226,RBR
Robroyston,51670,96910,11366,159946,0,Scotland,7780,RRN
Roby,58178,68150,36278,162606,0,North West,2261,ROB
Rochdale,331500,828948,187750,1348198,51545,North West,2924,RCD
Roche,762,3670,476,4908,0,South West,3532,ROC
Rochester,449488,905916,428258,1783662,55711,South East,5203,RTR
Rochford,197532,196522,180620,574674,0,East of England,6885,RFD
Rock Ferry,288686,262786,124986,676458,0,North West,2189,RFY
Rogart,618,266,0,884,0,Scotland,8671,ROG
Rogerstone,55026,1650,13750,70426,0,Wales,9921,ROR
Rolleston,2674,780,0,3454,0,East Midlands,6353,ROL
Roman Bridge,180,270,0,450,0,Wales,2444,RMB
Romford,3872186,6432522,1298370,11603078,578763,London,6886,RMF
Romiley,97764,75806,71236,244806,7391,North West,2833,RML
Romsey,91602,240036,52728,384366,0,South East,5943,ROM
Roose,15628,37426,10374,63428,0,North West,1962,ROO
Rose Grove,20918,26000,13016,59934,2190,North West,2722,RSG
Rose Hill Marple,43650,21708,34542,99900,0,North West,2873,RSH
Rosyth,49800,66136,10742,126678,0,Scotland,9190,ROS
Rotherham Central,136386,130386,48564,315336,88,Yorkshire and The Humber,6676,RMC
Rotherhithe,412958,855224,196968,1465150,0,London,1039,ROE
Roughton Road,10742,10236,3692,24670,0,East of England,7297,RNR
Rowlands Castle,19246,51130,42566,112942,0,South East,5658,RLN
Rowley Regis,244298,303144,215182,762624,0,West Midlands,4606,ROW
Roy Bridge,1602,918,0,2520,0,Scotland,8835,RYB
Roydon,45324,43122,13402,101848,0,East of England,6829,RYN
Royston,366080,530478,184456,1081014,14420,East of England,6090,RYS
Ruabon,53142,33574,4178,90894,0,Wales,4477,RUA
Rufford,7250,8424,2000,17674,0,North West,2315,RUF
Rugby,402390,1243008,267944,1913342,180763,West Midlands,1087,RUG
Rugeley Town,43818,59168,16860,119846,0,West Midlands,1135,RGT
Rugeley Trent Valley,31494,109376,13910,154780,37174,West Midlands,1084,RGL
Runcorn,139334,365400,16650,521384,35155,North West,2291,RUN
Runcorn East,112716,38052,14394,165162,1,North West,2294,RUE
Ruskington,48404,6040,6602,61046,0,East Midlands,6327,RKT
Ruswarp,262,2690,0,2952,0,Yorkshire and The Humber,8174,RUS
Rutherglen,149406,312018,87894,549318,0,Scotland,9787,RUT
Ryde Esplanade,22022,96198,15912,134132,0,South East,5542,RYD
Ryde Pier Head,16900,69476,6410,92786,0,South East,5541,RYP
Ryde St Johns Road,11314,33284,20798,65396,0,South East,5543,RYR
Ryder Brow,7344,6430,2986,16760,0,North West,2977,RRB
Rye (Sussex),66948,279196,84948,431092,0,South East,5024,RYE
Rye House,148064,148354,40182,336600,0,East of England,6820,RYH
Salford Central,263852,121278,142288,527418,0,North West,2798,SFD
Salford Crescent,558392,424726,137916,1121034,245036,North West,2794,SLD
Salfords (Surrey),50698,53062,12434,116194,0,South East,5380,SAF
Salhouse,2868,8760,2378,14006,0,East of England,7318,SAH
Salisbury,292596,1146336,182630,1621562,217777,South West,5663,SAL
Saltaire,207154,304488,124712,636354,0,Yorkshire and The Humber,8561,SAE
Saltash,42394,58098,36516,137008,0,South West,3587,STS
Saltburn,45298,189054,14704,249056,0,North East,7951,SLB
Saltcoats,58906,143522,16760,219188,0,Scotland,9547,SLT
Saltmarshe,162,916,0,1078,0,Yorkshire and The Humber,8033,SAM
Salwick,952,228,352,1532,0,North West,2673,SLW
Sandal and Agbrigg,89758,53604,31814,175176,0,Yorkshire and The Humber,8358,SNA
Sandbach,89588,113780,27184,230552,0,North West,1261,SDB
Sanderstead,234026,285652,103962,623640,0,London,5433,SNR
Sandhills,280904,384648,113212,778764,556339,North West,2249,SDL
Sandhurst (Berks),34392,66824,23906,125122,0,South East,5646,SND
Sandling,16154,39888,14936,70978,0,South East,5025,SDG
Sandown,15088,52610,15802,83500,0,South East,5525,SAN
Sandplace,54,1090,10,1154,0,South West,3584,SDP
Sandwell and Dudley,208886,442360,155446,806692,0,West Midlands,1149,SAD
Sandwich,42670,104684,120878,268232,0,South East,5026,SDW
Sandy,161738,303642,58688,524068,0,East of England,6172,SDY
Sankey For Penketh,2768,196,394,3358,0,North West,2388,SNK
Sanquhar,6532,10476,294,17302,0,Scotland,9549,SQH
Sarn,38216,1228,6966,46410,0,Wales,4270,SRR
Saundersfoot,3866,3226,18,7110,0,Wales,4108,SDF
Saunderton,47146,9450,8686,65282,0,South East,3056,SDR
Sawbridgeworth,153708,140416,60316,354440,0,East of England,6806,SAW
Saxilby,16588,49488,10084,76160,0,East Midlands,6328,SXY
Saxmundham,36250,114950,6014,157214,0,East of England,7224,SAX
Scarborough,114884,708232,39668,862784,0,Yorkshire and The Humber,8185,SCA
Scotscalder,106,18,0,124,0,Scotland,8672,SCT
Scotstounhill,90772,172184,31024,293980,0,Scotland,9996,SCH
Scunthorpe,52744,188054,12388,253186,755,Yorkshire and The Humber,6456,SCU
Sea Mills,43992,12998,5432,62422,0,South West,3254,SML
Seaford (Sussex),113744,316544,122614,552902,0,South East,5333,SEF
Seaforth and Litherland,165252,523414,191368,880034,0,North West,2250,SFL
Seaham,28620,68188,13762,110570,0,North East,7814,SEA
Seamer,27316,82250,11568,121134,34375,Yorkshire and The Humber,8178,SEM
Seascale,10452,27846,4740,43038,0,North West,2003,SSC
Seaton Carew,19830,39590,5634,65054,0,North East,8007,SEC
Seer Green and Jordans,46186,22476,19290,87952,0,South East,3061,SRG
Selby,95068,396588,62908,554564,24520,Yorkshire and The Humber,8201,SBY
Selhurst,336836,408502,242604,987942,2736,London,5434,SRS
Sellafield,74504,13928,48332,136764,126,North West,2004,SEL
Selling,25088,31750,20302,77140,0,South East,5179,SEG
Selly Oak,549088,814616,631218,1994922,0,West Midlands,1105,SLY
Settle,14806,114556,1206,130568,0,Yorkshire and The Humber,2107,SET
Seven Kings,1281120,1999448,501206,3781774,0,London,6893,SVK
Seven Sisters,1936466,3308728,868300,6113494,2009,London,6931,SVS
Sevenoaks,968632,1320686,850634,3139952,1219592,South East,5124,SEV
Severn Beach,118996,4290,105280,228566,0,South West,3205,SVB
Severn Tunnel Junction,135340,16282,14370,165992,28689,Wales,3679,STJ
Shadwell,1036636,2201342,468196,3706174,0,London,1082,SDE
Shalford (Surrey),32924,30544,11664,75132,0,South East,5638,SFR
Shanklin,26934,110596,12280,149810,0,South East,5529,SHN
Shawfair,16224,26796,1342,44362,0,Scotland,6963,SFI
Shawford,17982,67064,25068,110114,0,South East,5929,SHW
Shawlands,22752,44244,5116,72112,0,Scotland,9823,SHL
Sheerness-On-Sea,120144,148816,79554,348514,0,South East,5184,SSS
Sheffield,1522644,6683552,470816,8677012,766390,Yorkshire and The Humber,6691,SHF
Shelford (Cambs),62766,76000,31496,170262,0,East of England,7043,SED
Shenfield,2125910,2324570,655032,5105512,1056897,East of England,6888,SNF
Shenstone,37862,29698,62220,129780,0,West Midlands,1178,SEN
Shepherd's Bush,1713046,2871644,1120508,5705198,15841,London,9587,SPB
Shepherds Well,16114,23364,13932,53410,0,South East,5186,SPH
Shepley,23510,22990,8628,55128,0,Yorkshire and The Humber,8448,SPY
Shepperton,87490,115586,81858,284934,0,South East,5605,SHP
Shepreth,25738,50558,14786,91082,0,East of England,7044,STH
Sherborne,19202,132056,4224,155482,0,South West,5835,SHE
Sherburn-In-Elmet,22476,42900,17890,83266,0,Yorkshire and The Humber,8257,SIE
Sheringham,59424,162742,10056,232222,0,East of England,7319,SHM
Shettleston,124930,285306,63492,473728,0,Scotland,9903,SLS
Shieldmuir,32358,44256,7668,84282,0,Scotland,9552,SDM
Shifnal,54024,67150,20958,142132,0,West Midlands,4619,SFN
Shildon,13826,38044,5098,56968,0,North East,7893,SHD
Shiplake,34822,31350,12294,78466,0,South East,3150,SHI
Shipley (Yorks),367980,522038,216926,1106944,315355,Yorkshire and The Humber,8347,SHY
Shippea Hill,120,22,0,142,0,East of England,7073,SPP
Shipton,942,1238,174,2354,0,South East,3009,SIP
Shirebrook,40890,27082,9122,77094,0,East Midlands,1595,SHB
Shirehampton,47198,9910,10016,67124,0,South West,3206,SHH
Shireoaks,7718,23230,4578,35526,0,East Midlands,6570,SRO
Shirley,61890,109518,75712,247120,0,West Midlands,4526,SRL
Shoeburyness,173764,177148,142584,493496,0,East of England,7455,SRY
Sholing,26256,37338,23296,86890,0,South East,5930,SHO
Shoreditch High Street,1843010,4610400,600978,7054388,405919,London,1024,SDC
Shoreham (Kent),14738,35216,5302,55256,0,South East,5074,SEH
Shoreham-By-Sea,265622,623728,212126,1101476,0,South East,5277,SSE
Shortlands,394352,393136,147216,934704,9925,London,5084,SRT
Shotton,129040,41564,6440,177044,12408,Wales,2546,SHT
Shotts,45566,58112,8860,112538,0,Scotland,9739,SHS
Shrewsbury,635770,1045052,167514,1848336,193774,West Midlands,4387,SHR
Sidcup,882426,1000174,296516,2179116,0,London,5125,SID
Sileby,55392,33056,20966,109414,0,East Midlands,1902,SIL
Silecroft,1670,5772,596,8038,0,North West,2000,SIC
Silkstone Common,13478,12340,3278,29096,0,Yorkshire and The Humber,6782,SLK
Silver Street,511376,748468,220560,1480404,0,London,6972,SLV
Silverdale,6840,27738,7634,42212,0,North West,1968,SVR
Singer,87420,143648,57822,288890,0,Scotland,9988,SIN
Sittingbourne,505432,777584,593258,1876274,317297,South East,5187,SIT
Skegness,73214,282774,3756,359744,0,East Midlands,6265,SKG
Skewen,23462,2914,3952,30328,0,Wales,4217,SKE
Skipton,283092,595946,219928,1098966,9749,Yorkshire and The Humber,2728,SKI
Slade Green,323228,407500,186532,917260,47496,London,5154,SGR
Slaithwaite,78676,84130,25338,188144,0,Yorkshire and The Humber,8450,SWT
Slateford,25570,18368,430,44368,0,Scotland,9236,SLA
Sleaford,95648,106154,29290,231092,31340,East Midlands,6362,SLR
Sleights,742,4306,0,5048,0,Yorkshire and The Humber,8179,SLH
Slough,1319810,2551520,656302,4527632,1322225,South East,3172,SLO
Small Heath,67246,44120,32484,143850,0,West Midlands,4530,SMA
Smallbrook Junction,1142,6882,0,8024,0,South East,5494,SAB
Smethwick Galton Bridge,232606,259538,167612,659756,387565,West Midlands,1114,SGB
Smethwick Rolfe Street,144542,150868,106794,402204,10,West Midlands,1150,SMR
Smithy Bridge,46926,66420,26920,140266,0,North West,2660,SMB
Snaith,1388,122,0,1510,0,Yorkshire and The Humber,8036,SNI
Snodland,59288,51880,75224,186392,0,South East,5189,SDA
Snowdown,2608,3506,4804,10918,0,South East,5185,SWO
Soham,20912,27294,7312,55518,0,East of England,5247,SOJ
Sole Street,12704,17106,13260,43070,0,South East,5126,SOR
Solihull,327992,688092,324846,1340930,20130,West Midlands,4527,SOL
Somerleyton,2418,6074,518,9010,0,East of England,7320,SYT
South Acton,236250,283500,94918,614668,0,London,1452,SAT
South Bank,14022,14922,4692,33636,0,North East,7953,SBK
South Bermondsey,144090,228708,122310,495108,0,London,5425,SBM
South Croydon,320622,276568,135912,733102,0,London,5410,SCY
South Elmsall,123116,105036,40286,268438,0,Yorkshire and The Humber,8355,SES
South Greenford,8896,9652,2158,20706,0,London,3138,SGN
South Gyle,67888,83174,11650,162712,0,Scotland,9318,SGL
South Hampstead,108026,212314,74994,395334,0,London,1451,SOH
South Kenton,141844,286820,73722,502386,0,London,1453,SOK
South Merton,42606,47182,18934,108722,0,London,5292,SMO
South Milford,28324,59322,9926,97572,0,Yorkshire and The Humber,8142,SOM
South Ruislip,74502,62298,15878,152678,0,London,3057,SRU
South Tottenham,302450,489094,338100,1129644,0,London,7404,STO
South Wigston,42020,39054,9430,90504,0,East Midlands,1949,SWS
South Woodham Ferrers,96334,69118,85146,250598,0,East of England,6892,SOF
Southall,1217474,2528248,682476,4428198,0,London,3187,STL
Southampton Airport Parkway,207272,761812,109986,1079070,95308,South East,5922,SOA
Southampton Central,1060578,4061900,373194,5495672,1207893,South East,5932,SOU
Southbourne,50412,78644,52908,181964,0,South East,5263,SOB
Southbury,266236,458484,87372,812092,0,London,6947,SBU
Southease,7454,14088,1664,23206,0,South East,5339,SEE
Southend Airport,60614,55946,24798,141358,0,East of England,4787,SIA
Southend Central,605474,881468,554478,2041420,2481,East of England,7456,SOC
Southend East,343536,500128,314600,1158264,0,East of England,7457,SOE
Southend Victoria,374166,544722,342652,1261540,2049,East of England,7420,SOV
Southminster,25226,26564,26504,78294,0,East of England,6890,SMN
Southport,445586,2446116,447880,3339582,16208,North West,2262,SOP
Southwick,84874,149634,48484,282992,0,South East,5286,SWK
Sowerby Bridge,136140,154288,48286,338714,0,Yorkshire and The Humber,8527,SOW
Spalding,50454,104812,11594,166860,0,East Midlands,6388,SPA
Spean Bridge,3586,2346,0,5932,0,Scotland,8836,SBR
Spital,151504,129926,77664,359094,0,North West,2199,SPI
Spondon,6102,340,2094,8536,0,East Midlands,1699,SPO
Spooner Row,298,84,0,382,0,East of England,7379,SPN
Spring Road,36462,51670,32910,121042,0,West Midlands,4535,SRI
Springburn,92998,136014,30010,259022,10425,Scotland,9997,SPR
Springfield,1120,70,0,1190,0,Scotland,9175,SPF
Squires Gate,6418,17282,1834,25534,0,North West,2666,SQU
St Albans Abbey,42718,59200,9206,111124,0,East of England,1562,SAA
St Albans City,2022094,2933882,616176,5572152,121850,East of England,1548,SAC
St Andrews Road,13038,1568,2716,17322,0,South West,3252,SAR
St Annes-On-The-Sea,23686,100774,8562,133022,0,North West,2672,SAS
St Austell,46358,336840,48090,431288,0,South West,3534,SAU
St Bees,19084,47226,5080,71390,0,North West,2002,SBS
St Budeaux Ferry Road,128,2380,0,2508,0,South West,3590,SBF
St Budeaux Victoria Road,1556,5634,908,8098,0,South West,3592,SBV
St Columb Road,490,2304,0,2794,0,South West,3536,SCR
St Denys,49154,106560,20110,175824,34969,South East,5914,SDN
St Erth,6798,352456,5600,364854,230744,South West,3537,SER
St Germans,5802,41960,17020,64782,0,South West,3586,SGM
St Helens Central,185304,255160,96290,536754,0,North West,2341,SNH
St Helens Junction,54506,79642,29026,163174,23,North West,2340,SHJ
St Helier (London),48082,56350,35624,140056,0,London,5290,SIH
St Ives (Cornwall),0,717476,2586,720062,0,South West,3538,SIV
St James Park (Exeter),33862,81672,7280,122814,0,South West,5751,SJP
St James Street (Walthamstow),405156,673826,168518,1247500,0,London,6973,SJS
St Johns (London),231934,305570,187348,724852,0,London,5059,SAJ
St Keyne Wishing Well Halt,1292,232,0,1524,0,South West,3572,SKN
St Leonards Warrior Square,162236,502982,138286,803504,150714,South East,5239,SLQ
St Margarets (Herts),113348,115024,39616,267988,0,East of England,6821,SMT
St Margarets (London),339260,370458,109864,819582,0,London,5604,SMG
St Mary Cray,396644,493238,252570,1142452,0,London,5073,SMY
St Michaels,288558,415130,247182,950870,0,North West,2248,STM
St Neots,247822,496974,141292,886088,0,East of England,6110,SNO
Stafford,526002,954158,158702,1638862,338457,West Midlands,1268,STA
Staines,730202,942622,306888,1979712,254906,South East,5670,SNS
Stallingborough,1670,2598,0,4268,0,Yorkshire and The Humber,6287,SLL
Stalybridge,223748,276660,118938,619346,71513,North West,2983,SYB
Stamford (Lincs),118606,106792,22300,247698,0,East Midlands,6140,SMD
Stamford Hill,173696,266298,84310,524304,0,London,6968,SMH
Stanford-Le-Hope,249060,182804,146924,578788,0,East of England,7458,SFO
Stanlow and Thornton,0,0,0,0,0,North West,2159,SNT
Stansted Airport,5177772,2707914,20788,7906474,2583,East of England,6834,SSD
Stansted Mountfitchet,174660,196392,84184,455236,20406,East of England,6833,SST
Staplehurst,130346,303076,178722,612144,0,South East,5228,SPU
Stapleton Road,140562,59492,11664,211718,0,South West,3250,SRD
Starbeck,55902,118858,18870,193630,0,Yorkshire and The Humber,8221,SBE
Starcross,39902,44300,22918,107120,0,South West,3413,SCS
Staveley (Cumbria),4146,20682,9826,34654,0,North West,1977,SVL
Stechford,104074,119120,90754,313948,0,West Midlands,1043,SCF
Steeton and Silsden,139582,244400,107948,491930,0,Yorkshire and The Humber,8469,SON
Stepps,68180,108920,16128,193228,0,Scotland,9842,SPS
Stevenage,1409124,2246782,394422,4050328,1957268,East of England,6092,SVG
Stevenston,23330,51982,6924,82236,0,Scotland,9553,STV
Stewartby,8740,9116,54588,72444,0,East of England,1386,SWR
Stewarton,56472,107776,19132,183380,0,Scotland,9554,STT
Stirling,577796,1227642,121752,1927190,286373,Scotland,9888,STG
Stockport,693942,2196242,252494,3142678,364310,North West,2771,SPT
Stocksfield,11862,23106,3896,38864,0,North East,7513,SKS
Stocksmoor,8404,9156,4170,21730,0,Yorkshire and The Humber,8451,SSM
Stockton,25732,51636,7400,84768,0,North East,7975,STK
Stoke Mandeville,73282,54054,56140,183476,0,South East,1467,SKM
Stoke Newington,355822,583842,137796,1077460,0,London,6934,SKW
Stoke-On-Trent,632446,1745752,127190,2505388,126972,West Midlands,1314,SOT
Stone (Staffs),133818,64772,15450,214040,0,West Midlands,1316,SNE
Stone Crossing,86336,60632,75180,222148,0,South East,5248,SCG
Stonebridge Park,344162,664408,179400,1187970,0,London,1454,SBP
Stonegate,30404,59700,28150,118254,0,South East,5240,SOG
Stonehaven,92610,243774,23496,359880,0,Scotland,8964,STN
Stonehouse,67910,80838,8360,157108,0,South West,4770,SHU
Stoneleigh,280780,309006,76884,666670,0,South East,5606,SNL
Stourbridge Junction,247794,505790,339040,1092624,238472,West Midlands,4646,SBJ
Stourbridge Town,59020,107220,128844,295084,0,West Midlands,4643,SBT
Stow,23372,33252,3182,59806,0,Scotland,9396,SOI
Stowmarket,183938,436526,144088,764552,55744,East of England,7355,SMK
Stranraer,12772,27366,0,40138,0,Scotland,9555,STR
Stratford (London),13230372,24217934,6688478,44136784,5523622,London,6969,SRA
Stratford International,594578,1603464,318740,2516782,0,London,7222,SFA
Stratford-Upon-Avon,106814,374380,190034,671228,276,West Midlands,4558,SAV
Stratford-upon-Avon Parkway,25300,44986,2780,73066,880,West Midlands,6794,STY
Strathcarron,3596,1928,0,5524,0,Scotland,8673,STC
Strawberry Hill,220456,271840,58412,550708,368,London,5607,STW
Streatham (Greater London),694452,888002,406344,1988798,295661,London,5383,STE
Streatham Common,717704,912356,638868,2268928,83725,London,5384,SRC
Streatham Hill,409208,523808,250286,1183302,0,London,5435,SRH
Streethouse,8218,7712,3040,18970,0,Yorkshire and The Humber,8543,SHC
Strines,5480,6286,3056,14822,0,North West,2834,SRN
Stromeferry,866,278,0,1144,0,Scotland,8674,STF
Strood (Kent),331778,395128,263192,990098,384267,South East,5191,SOO
Stroud (Gloucs),154368,317090,73610,545068,0,South West,4771,STD
Sturry,24414,38826,21780,85020,0,South East,5029,STU
Styal,8578,8364,4512,21454,0,North West,2868,SYA
Sudbury (Suffolk),81878,139860,56796,278534,0,East of England,7098,SUY
Sudbury and Harrow Road,14390,2066,3322,19778,0,London,1483,SUD
Sudbury Hill Harrow,28228,15460,3942,47630,0,London,1484,SDH
Sugar Loaf,74,324,0,398,0,Wales,4157,SUG
Summerston,22014,54746,5028,81788,0,Scotland,9959,SUM
Sunbury,104212,114744,79044,298000,0,South East,5608,SUU
Sunderland,124334,322066,35414,481814,4711,North East,7640,SUN
Sundridge Park,67130,59908,15398,142436,0,London,5155,SUP
Sunningdale,187182,222372,51864,461418,0,South East,5671,SNG
Sunnymeads,12428,18020,2166,32614,0,South East,5675,SNY
Surbiton,2247516,3409680,952822,6610018,434021,London,5571,SUR
Surrey Quays,1202320,2456290,690004,4348614,516748,London,1083,SQE
Sutton (London),1452550,1989394,898318,4340262,359251,London,5385,SUO
Sutton Coldfield,210622,325580,269202,805404,0,West Midlands,1044,SUT
Sutton Common,87508,86070,51762,225340,0,London,5436,SUC
Sutton Parkway,79286,35888,16918,132092,0,East Midlands,1861,SPK
Swale,4448,2416,4416,11280,0,South East,5249,SWL
Swanley,416708,593366,109448,1119522,263471,South East,5075,SAY
Swanscombe,94906,95006,68808,258720,0,South East,5156,SWM
Swansea,806700,964572,112302,1883574,96651,Wales,4222,SWA
Swanwick,156486,260786,67306,484578,0,South East,5920,SNW
Sway,14476,38846,12584,65906,0,South East,5884,SWY
Swaythling,17180,35896,10204,63280,0,South East,5933,SWG
Swinderby,10474,1826,886,13186,0,East Midlands,6355,SWD
Swindon (Wilts),309476,2053654,224884,2588014,189382,South West,3333,SWI
Swineshead,546,212,468,1226,0,East Midlands,6228,SWE
Swinton (Manchester),57892,45930,25670,129492,0,North West,2800,SNN
Swinton (South Yorks),104834,102888,55140,262862,2204,Yorkshire and The Humber,6686,SWN
Sydenham (London),1007634,1617142,480410,3105186,0,London,5437,SYD
Sydenham Hill,206400,235890,99784,542074,0,London,5085,SYH
Syon Lane,348068,200828,118910,667806,0,London,5609,SYL
Syston,99514,26976,22612,149102,0,East Midlands,1900,SYS
Tackley,3550,15712,1636,20898,0,South East,3195,TAC
Tadworth,76780,68594,27984,173358,0,South East,5386,TAD
Taffs Well,122602,7134,34946,164682,0,Wales,3880,TAF
Tain,14838,4262,506,19606,0,Scotland,8676,TAI
Talsarnau,2366,664,0,3030,0,Wales,4479,TAL
Talybont,16914,5908,3224,26046,0,Wales,4355,TLB
Tal-y-Cafn,952,430,6,1388,0,Wales,2463,TLC
Tame Bridge Parkway,171868,222966,110054,504888,0,West Midlands,1010,TAB
Tamworth,414442,472394,57880,944716,202840,West Midlands,1322,TAM
Taplow,94400,152272,53410,300082,0,South East,3151,TAP
Tattenham Corner,56694,58216,20532,135442,0,South East,5387,TAT
Taunton,220386,1108222,69490,1398098,69064,South West,3471,TAU
Taynuilt,6852,3706,31468,42026,0,Scotland,8727,TAY
Teddington,522174,711120,147236,1380530,66384,London,5572,TED
Teesside Airport,0,2,0,2,0,North East,7521,TEA
Teignmouth,93332,466904,131148,691384,0,South West,3430,TGM
Telford Central,236540,546372,99764,882676,2986,West Midlands,4691,TFC
Templecombe,8812,54938,4526,68276,0,South West,5837,TMC
Tenby,58674,34458,74,93206,0,Wales,4110,TEN
Teynham,40634,51622,42546,134802,0,South East,5193,TEY
Thames Ditton,275762,263382,78256,617400,0,South East,5610,THD
Thatcham,101504,196444,64950,362898,0,South East,3152,THA
Thatto Heath,43516,48274,23552,115342,0,North West,2264,THH
The Hawthorns,70574,102630,93106,266310,0,West Midlands,4523,THW
The Lakes (Warks),3016,3620,3896,10532,0,West Midlands,4538,TLK
Theale,100438,131992,50550,282980,0,South East,3153,THE
Theobalds Grove,210652,317538,38404,566594,0,East of England,6949,TEO
Thetford,55208,191538,29776,276522,6,East of England,7203,TTF
Thirsk,58848,154032,18270,231150,0,Yorkshire and The Humber,8191,THI
Thornaby,86636,375408,49044,511088,46054,North East,7976,TBY
Thorne North,33848,48172,19020,101040,1281,Yorkshire and The Humber,6530,TNN
Thorne South,20494,17544,9938,47976,0,Yorkshire and The Humber,6531,TNS
Thornford,894,1826,196,2916,0,South West,5849,THO
Thornliebank,64508,102602,23344,190454,0,Scotland,9812,THB
Thornton Abbey,306,828,0,1134,0,Yorkshire and The Humber,6210,TNA
Thornton Heath,558144,792280,564798,1915222,0,London,5388,TTH
Thorntonhall,5184,8216,1480,14880,0,Scotland,9825,THT
Thorpe Bay,267908,201362,127550,596820,0,East of England,7460,TPB
Thorpe Culvert,166,230,0,396,0,East Midlands,6267,TPC
Thorpe-le-Soken,37040,46902,35106,119048,229068,East of England,6857,TLS
Three Bridges,773500,1480930,537456,2791886,718405,South East,5491,TBD
Three Oaks,3188,5638,3370,12196,0,South East,5028,TOK
Thurgarton,1378,146,60,1584,0,East Midlands,6203,THU
Thurnscoe,32936,21756,13580,68272,0,Yorkshire and The Humber,8282,THC
Thurso,15466,15374,606,31446,0,Scotland,8677,THS
Thurston,38138,40202,17380,95720,0,East of England,7356,TRS
Tilbury Town,415034,256100,287628,958762,111134,East of England,7462,TIL
Tile Hill,118336,209266,100784,428386,0,West Midlands,1035,THL
Tilehurst,81468,166222,72320,320010,0,South East,3154,TLH
Tipton,84806,150444,61844,297094,0,West Midlands,1159,TIP
Tir-Phil,21076,838,4254,26168,0,Wales,4025,TIR
Tisbury,23356,104594,23680,151630,0,South West,5798,TIS
Tiverton Parkway,29134,452466,42590,524190,0,South West,3474,TVP
Todmorden,172144,260270,84330,516744,0,Yorkshire and The Humber,2677,TOD
Tolworth,201196,199190,95992,496378,0,London,5573,TOL
Ton Pentre,41664,2224,9734,53622,0,Wales,3897,TPN
Tonbridge,795088,1452098,1255750,3502936,321741,South East,5229,TON
Tondu,31544,1342,7050,39936,0,Wales,4271,TDU
Tonfanau,992,564,0,1556,0,Wales,4432,TNF
Tonypandy,60892,3058,14910,78860,0,Wales,3882,TNP
Tooting,262056,287860,153056,702972,0,London,5389,TOO
Topsham,134060,73330,20242,227632,0,South West,5758,TOP
Torquay,41486,361990,51972,455448,3700,South West,3434,TQY
Torre,64770,148512,118562,331844,0,South West,3432,TRR
Totnes,40898,556808,89688,687394,0,South West,3558,TOT
Tottenham Court Road,9387002,21242642,4248124,34877768,0,London,6556,TCR
Tottenham Hale,2909790,3788882,864978,7563650,502460,London,6951,TOM
Totton,59116,113802,27360,200278,0,South East,5921,TTN
Town Green,76880,226832,56868,360580,0,North West,2283,TWN
Trafford Park,17526,12866,6376,36768,0,North West,2969,TRA
Trefforest,475408,23700,55004,554112,0,Wales,3887,TRF
Trefforest Estate,35642,1768,9070,46480,0,Wales,3886,TRE
Trehafod,20164,860,5958,26982,0,Wales,3888,TRH
Treherbert,80364,3922,36910,121196,0,Wales,3889,TRB
Treorchy,54592,2986,25826,83404,0,Wales,3891,TRY
Trimley,18532,17956,4676,41164,0,East of England,7225,TRM
Tring,198956,285566,68686,553208,0,East of England,1393,TRI
Troed-Y-Rhiw,22072,774,10816,33662,0,Wales,4276,TRD
Troon,98358,209090,29694,337142,3904,Scotland,9562,TRN
Trowbridge,300822,342102,91844,734768,36255,South West,3348,TRO
Truro,105302,837196,158094,1100592,240812,South West,3540,TRU
Tulloch,1128,416,0,1544,0,Scotland,8837,TUL
Tulse Hill,680414,893942,302766,1877122,547235,London,5390,TUH
Tunbridge Wells,574382,1359508,632054,2565944,72163,South East,5230,TBW
Turkey Street,292940,440472,44402,777814,0,London,6952,TUR
Tutbury and Hatton,24158,29638,2760,56556,0,East Midlands,1783,TUT
Tweedbank,99158,197300,5070,301528,0,Scotland,9500,TWB
Twickenham,1328622,2218304,472198,4019124,343576,London,5574,TWI
Twyford,394528,527072,160060,1081660,555106,South East,3155,TWY
Ty Croes,2774,1862,246,4882,0,Wales,2439,TYC
Ty Glas,54160,1656,15302,71118,0,Wales,3817,TGS
Tygwyn,834,218,0,1052,0,Wales,4357,TYG
Tyndrum Lower,3020,1630,0,4650,1343,Scotland,8728,TYL
Tyseley,58714,43532,45854,148100,951,West Midlands,4518,TYS
Tywyn,49450,18930,21526,89906,0,Wales,4433,TYW
Uckfield,56250,100882,43140,200272,0,South East,5334,UCK
Uddingston,207758,294362,65682,567802,0,Scotland,9776,UDD
Ulceby,1102,1758,0,2860,0,Yorkshire and The Humber,6211,ULC
Ulleskelf,4318,4810,1192,10320,0,Yorkshire and The Humber,8261,ULL
Ulverston,47564,169884,39910,257358,0,North West,2010,ULV
Umberleigh,11092,17816,17000,45908,0,South West,5826,UMB
University (Birmingham),909998,1047160,676330,2633488,0,West Midlands,4504,UNI
Uphall,153608,179230,25248,358086,0,Scotland,9373,UHA
Upholland,11912,7882,1904,21698,0,North West,2364,UPL
Upminster,1688162,2220578,497628,4406368,764941,London,7464,UPM
Upper Halliford,26180,24160,26174,76514,0,South East,5613,UPH
Upper Holloway,365578,476458,316964,1159000,0,London,1524,UHL
Upper Tyndrum,2456,1620,0,4076,123,Scotland,8838,UTY
Upper Warlingham,259498,261606,108582,629686,0,South East,5391,UWL
Upton (Merseyside),13478,3622,1178,18278,0,North West,2141,UPT
Upwey,11360,30696,1072,43128,57243,South West,5967,UPW
Urmston,132358,95874,46306,274538,0,North West,2938,URM
Uttoxeter,55848,81976,6446,144270,0,West Midlands,1342,UTT
Valley,7566,4352,518,12436,0,Wales,2440,VAL
Vauxhall,4312218,5976372,2723744,13012334,0,London,5597,VXH
Virginia Water,195964,213224,69772,478960,122300,South East,5676,VIR
Waddon,185564,197944,100888,484396,0,London,5392,WDO
Wadhurst,68566,142698,75752,287016,0,South East,5231,WAD
Wainfleet,27410,11464,2120,40994,0,East Midlands,6268,WFL
Wakefield Kirkgate,73600,382258,51914,507772,82663,Yorkshire and The Humber,8584,WKK
Wakefield Westgate,280780,1458282,198050,1937112,105852,Yorkshire and The Humber,8591,WKF
Walkden,103464,84020,54090,241574,0,North West,2612,WKD
Wallasey Grove Road,157592,196496,86682,440770,0,North West,2154,WLG
Wallasey Village,146306,142354,85392,374052,0,North West,2265,WLV
Wallington,496336,599100,222132,1317568,0,London,5394,WLT
Wallyford,113218,84984,10636,208838,0,Scotland,9365,WAF
Walmer,32384,87898,58968,179250,0,South East,5041,WAM
Walsall,316308,449138,205384,970830,12965,West Midlands,1216,WSL
Walsden,21418,29406,14762,65586,0,Yorkshire and The Humber,2665,WDN
Waltham Cross,397146,588082,109880,1095108,0,East of England,6823,WLC
Walthamstow Central,1108392,1873096,428220,3409708,0,London,6953,WHC
Walthamstow Queen's Road,253606,341906,169456,764968,0,London,7407,WMW
Walton (Merseyside),73950,165778,178440,418168,0,North West,2251,WAO
Walton-On-Thames,752828,861248,420440,2034516,0,South East,5575,WAL
Walton-on-the-Naze,19710,70466,21224,111400,0,East of England,6858,WON
Wanborough,24524,22746,9978,57248,0,South East,5639,WAN
Wandsworth Common,291016,296606,159060,746682,0,London,5395,WSW
Wandsworth Road,201844,259880,107894,569618,0,London,5372,WWR
Wandsworth Town,1221664,1460754,656852,3339270,0,London,5576,WNT
Wanstead Park,239504,390232,261206,890942,11671,London,7408,WNP
Wapping,651162,1399814,208516,2259492,0,London,1085,WPE
Warblington,11100,9326,2248,22674,0,South East,5264,WBL
Ware (Herts),358338,363644,84862,806844,0,East of England,6824,WAR
Wareham (Dorset),52406,188720,11960,253086,0,South West,5959,WRM
Wargrave,28830,28884,11010,68724,0,South East,3158,WGV
Warminster,69418,194938,31096,295452,12008,South West,5505,WMN
Warnham,4214,3278,688,8180,0,South East,5316,WNH
Warrington Bank Quay,327340,735256,63220,1125816,467900,North West,2384,WBQ
Warrington Central,320576,720062,61912,1102550,303098,North West,2390,WAC
Warrington West,84082,183030,13218,280330,3933,North West,6583,WAW
Warwick,161522,258150,62012,481684,0,West Midlands,4600,WRW
Warwick Parkway,80368,285618,11146,377132,0,West Midlands,8530,WRP
Water Orton,32948,4346,2090,39384,0,West Midlands,1121,WTO
Waterbeach,102604,156314,50212,309130,0,East of England,7079,WBC
Wateringbury,16206,23390,17912,57508,0,South East,5241,WTR
Waterloo (Merseyside),302558,785450,236008,1324016,0,North West,2133,WLO
Watford High Street,204028,923986,34408,1162422,0,East of England,1455,WFH
Watford Junction,1499978,3462674,573444,5536096,281507,East of England,1402,WFJ
Watford North,14404,24096,15228,53728,0,East of England,1403,WFN
Watlington,25050,67950,14724,107724,0,East of England,7057,WTG
Watton-At-Stone,49542,67842,24562,141946,0,East of England,6095,WAS
Waun-gron Park,42748,2140,7880,52768,0,Wales,3796,WNG
Wavertree Technology Park,96366,82996,60930,240292,0,North West,8589,WAV
Weeley,11274,14746,6622,32642,0,East of England,6859,WEE
Weeton,21798,32458,5420,59676,0,Yorkshire and The Humber,8509,WET
Welham Green,88170,90566,18222,196958,0,East of England,6073,WMG
Welling,542374,563670,275908,1381952,0,London,5128,WLI
Wellingborough,94756,476412,167732,738900,4220,East Midlands,1940,WEL
Wellington (Shropshire),223060,230972,92564,546596,0,West Midlands,4690,WLN
Welshpool,82714,50360,7480,140554,0,Wales,4434,WLP
Welwyn Garden City,856162,991768,232852,2080782,41800,East of England,6183,WGC
Welwyn North,138978,185288,43190,367456,0,East of England,6096,WLW
Wem,42184,34854,9468,86506,0,West Midlands,1347,WEM
Wembley Central,729578,2075610,534962,3340150,50670,London,1423,WMB
Wembley Stadium,168260,445712,43422,657394,0,London,1509,WCX
Wemyss Bay,62258,97822,3956,164036,0,Scotland,9673,WMS
Wendover,128058,96546,86996,311600,0,South East,1466,WND
Wennington,886,4514,412,5812,0,North West,2681,WNN
West Allerton,24610,21890,16470,62970,0,North West,2266,WSA
West Brompton,1084230,1800302,626038,3510570,0,London,8875,WBP
West Byfleet,331758,375060,200572,907390,0,South East,5684,WBY
West Calder,39558,44652,6250,90460,0,Scotland,9250,WCL
West Croydon,1126816,1837970,727100,3691886,256877,London,5411,WCY
West Drayton,850296,1521408,290180,2661884,0,London,3174,WDT
West Dulwich,279150,346576,98516,724242,0,London,5086,WDU
West Ealing,421480,682444,157550,1261474,31302,London,3188,WEA
West Ham,3025674,4462908,1563072,9051654,5268,London,7474,WEH
West Hampstead,1002410,1673702,621216,3297328,827541,London,1421,WHD
West Hampstead Thameslink,950624,1474470,437354,2862448,1056557,London,1525,WHP
West Horndon,156994,66486,64230,287710,0,East of England,7466,WHR
West Kilbride,32238,68898,9766,110902,0,Scotland,9564,WKB
West Kirby,208340,654736,95692,958768,0,North West,2201,WKI
West Malling,161390,307074,137550,606014,0,South East,5129,WMA
West Norwood,386862,503052,211568,1101482,25947,London,5438,WNW
West Ruislip,80326,63132,10726,154184,1756,London,3059,WRU
West Runton,19828,12500,590,32918,0,East of England,7329,WRN
West St Leonards,24354,53958,35012,113324,0,South East,5242,WLD
West Sutton,93330,99148,32494,224972,0,London,5293,WSU
West Wickham,265374,284836,53974,604184,0,London,5054,WWI
West Worthing,116468,330520,90802,537790,0,South East,5278,WWO
Westbury,142710,335688,40598,518996,246705,South West,5712,WSB
Westcliff,384658,328402,207660,920720,0,East of England,7476,WCF
Westcombe Park,326830,375784,113360,815974,0,London,5151,WCB
Westenhanger,13804,21062,19506,54372,0,South East,5030,WHA
Wester Hailes,25954,10464,1770,38188,0,Scotland,9231,WTA
Westerfield,6276,7052,642,13970,4453,East of England,7226,WFI
Westerton,137720,319398,56284,513402,16227,Scotland,9998,WES
Westgate-On-Sea,28012,63616,37878,129506,0,South East,5195,WGA
Westhoughton,75562,63240,41228,180030,0,North West,2619,WHG
Weston Milton,45782,41908,6396,94086,0,South West,3388,WNM
Weston-Super-Mare,235848,640196,63760,939804,6498,South West,3391,WSM
Wetheral,6840,20366,3460,30666,0,North West,7572,WRL
Weybridge,779856,618200,282924,1680980,473962,South East,5577,WYB
Weymouth,99830,529260,12522,641612,6596,South West,5965,WEY
Whaley Bridge,24806,65464,15572,105842,0,East Midlands,2772,WBR
Whalley (Lancashire),18890,55292,9994,84176,0,North West,2736,WHE
Whatstandwell,7536,16562,850,24948,0,East Midlands,1585,WTS
Whifflet,57230,92096,18674,168000,2671,Scotland,9753,WFF
Whimple,9134,25654,5020,39808,0,South West,5759,WHM
Whinhill,8394,17068,1842,27304,0,Scotland,9665,WNL
Whiston,53572,97466,51886,202924,0,North West,2161,WHN
Whitby,20050,79306,27010,126366,0,Yorkshire and The Humber,8184,WTB
Whitchurch (Cardiff),14128,892,3168,18188,0,Wales,3896,WHT
Whitchurch (Hampshire),31996,110144,37178,179318,0,South East,5527,WCH
Whitchurch (Shropshire),64312,47610,4552,116474,0,West Midlands,1348,WTC
White Hart Lane,556446,1184782,249976,1991204,0,London,6956,WHL
White Notley,3250,3456,1422,8128,0,East of England,6846,WNY
Whitechapel,6824148,13151620,3331442,23307210,579,London,4935,ZLW
Whitecraigs,76944,127282,10606,214832,0,Scotland,9777,WCR
Whitehaven,59532,164302,17054,240888,0,North West,2048,WTH
Whitland,23894,8182,3274,35350,1589,Wales,4111,WTL
Whitley Bridge,740,90,76,906,0,Yorkshire and The Humber,8130,WBD
Whitlocks End,58146,71606,16972,146724,0,West Midlands,4539,WTE
Whitstable,116150,448800,156080,721030,0,South East,5196,WHI
Whittlesea,19460,11202,3076,33738,0,East of England,7187,WLE
Whittlesford Parkway,93170,202816,80446,376432,0,East of England,7047,WLF
Whitton (London),389084,478442,142416,1009942,0,London,5611,WTN
Whitwell (Derbyshire),7026,4706,1058,12790,0,East Midlands,6551,WWL
Whyteleafe,93436,113838,25786,233060,0,South East,5396,WHY
Whyteleafe South,43772,44882,15186,103840,0,South East,5439,WHS
Wick,7484,6442,998,14924,0,Scotland,8680,WCK
Wickford,610930,456884,436938,1504752,361285,East of England,6891,WIC
Wickham Market,15014,38006,4254,57274,0,East of England,7227,WCM
Widdrington,1714,78,700,2492,0,North East,7695,WDD
Widnes,150018,210256,16594,376868,0,North West,2391,WID
Widney Manor,74438,91732,75080,241250,0,West Midlands,4528,WMR
Wigan North Western,275142,765188,142634,1182964,694621,North West,2363,WGN
Wigan Wallgate,253582,705224,131458,1090264,271377,North West,2406,WGW
Wigton,17030,39360,6864,63254,0,North West,2098,WGT
Wildmill,15510,4872,3266,23648,0,Wales,3965,WMI
Willesden Junction,1975832,3379508,1012418,6367758,1972936,London,1457,WIJ
Williamwood,52030,95378,15496,162904,0,Scotland,9781,WLM
Willington,13802,13070,802,27674,0,East Midlands,1905,WIL
Wilmcote,5110,9590,1876,16576,0,West Midlands,4568,WMC
Wilmslow,317878,533348,141618,992844,90395,North West,2774,WML
Wilnecote (Staffs),56518,6924,11286,74728,0,West Midlands,1056,WNE
Wimbledon,3729400,5872068,2092408,11693876,1153942,London,5578,WIM
Wimbledon Chase,98050,88462,47136,233648,0,London,5612,WBO
Winchelsea,1618,7364,3022,12004,0,South East,5042,WSE
Winchester,716448,2270022,737274,3723744,81031,South East,5924,WIN
Winchfield,61590,85470,67796,214856,0,South East,5528,WNF
Winchmore Hill,480534,565266,125040,1170840,0,London,6024,WIH
Windermere,6194,297978,12052,316224,0,North West,1978,WDM
Windsor and Eton Central,367866,1050204,162096,1580166,31942,South East,3175,WNC
Windsor and Eton Riverside,307718,681372,69370,1058460,42234,South East,5672,WNR
Winnersh,84270,137182,88838,310290,0,South East,5697,WNS
Winnersh Triangle,78080,73718,27334,179132,0,South East,5698,WTI
Winsford,56526,110158,7486,174170,0,North West,2269,WSF
Wishaw,109916,158684,37648,306248,0,Scotland,9694,WSH
Witham,428766,588948,600066,1617780,123522,East of England,6844,WTM
Witley,75222,54124,43184,172530,0,South East,5640,WTY
Witton (West Midlands),51072,95708,44610,191390,0,West Midlands,1011,WTT
Wivelsfield,106894,192110,94586,393590,17532,South East,5341,WVF
Wivenhoe,41194,170962,66760,278916,1238,East of England,6860,WIV
Woburn Sands,5278,10834,8506,24618,0,South East,1539,WOB
Woking,2100250,2408232,813964,5322446,944832,South East,5685,WOK
Wokingham,468550,843998,247778,1560326,52270,South East,5696,WKM
Woldingham,89464,74406,100488,264358,0,South East,5440,WOH
Wolverhampton,1124554,2666212,655098,4445864,222035,West Midlands,1218,WVH
Wolverton,68924,131998,65656,266578,0,South East,1364,WOL
Wombwell,89484,52170,29554,171208,0,Yorkshire and The Humber,6688,WOM
Wood End,3196,3030,4740,10966,0,West Midlands,4536,WDE
Wood Street,570304,892652,147782,1610738,0,London,6954,WST
Woodbridge,31344,147642,10798,189784,0,East of England,7228,WDB
Woodgrange Park,209882,337098,228956,775936,0,London,7467,WGR
Woodhall,14056,18692,4366,37114,0,Scotland,9639,WDL
Woodhouse,12318,13584,1590,27492,0,Yorkshire and The Humber,6732,WDH
Woodlesford,115496,58032,29828,203356,0,Yorkshire and The Humber,8578,WDS
Woodley,21644,10138,10362,42144,0,North West,2835,WLY
Woodmansterne,46392,55634,13070,115096,0,London,5441,WME
Woodsmoor,79282,63288,52144,194714,0,North West,2773,WSR
Wool,34894,118430,7258,160582,0,South West,5960,WOO
Woolston,35898,45920,23050,104868,0,South East,5925,WLS
Woolwich,2523340,4346348,1469888,8339576,0,London,6562,WWC
Woolwich Arsenal,729416,1279664,465776,2474856,0,London,5152,WWA
Woolwich Dockyard,104916,153584,79182,337682,0,London,5153,WWD
Wootton Wawen,2932,6248,1862,11042,0,West Midlands,4540,WWW
Worcester Foregate Street,506586,678142,398248,1582976,459965,West Midlands,4893,WOF
Worcester Park,459120,541948,187920,1188988,0,London,5579,WCP
Worcester Shrub Hill,152750,204478,120082,477310,143413,West Midlands,4891,WOS
Worcestershire Parkway,116716,198818,19124,334658,85405,West Midlands,6580,WOP
Workington,53344,120044,17498,190886,0,North West,2040,WKG
Worksop,117588,271358,31148,420094,26663,East Midlands,6574,WRK
Worle,127544,173530,18266,319340,0,South West,3390,WOR
Worplesdon,44940,35256,28720,108916,0,South East,5686,WPL
Worstead,10924,9354,6538,26816,0,East of England,7326,WRT
Worthing,422314,1141154,327944,1891412,18160,South East,5279,WRH
Wrabness,4632,8526,6848,20006,0,East of England,6907,WRB
Wraysbury,28732,28978,7010,64720,0,South East,5673,WRY
Wrenbury,5958,2154,0,8112,0,North West,1350,WRE
Wressle,148,304,42,494,0,Yorkshire and The Humber,8123,WRS
Wrexham Central,34004,5902,1900,41806,0,Wales,4486,WXC
Wrexham General,248030,223096,17568,488694,8813,Wales,4487,WRX
Wye,52152,70798,61776,184726,0,South East,5031,WYE
Wylam,22576,51994,10294,84864,0,North East,7514,WYM
Wylde Green,110554,172224,105786,388564,0,West Midlands,1138,WYL
Wymondham,52744,121660,22048,196452,0,East of England,7383,WMD
Wythall,14362,25774,11434,51570,0,West Midlands,4532,WYT
Yalding,7518,14008,7702,29228,0,South East,5232,YAL
Yardley Wood,91484,130710,79894,302088,0,West Midlands,4537,YRD
Yarm,23440,70542,4836,98818,0,North East,7917,YRM
Yate,99528,115454,23124,238106,0,South West,3380,YAE
Yatton,121448,231952,99106,452506,0,South West,3392,YAT
Yeoford,13484,2846,5572,21902,0,South West,5827,YEO
Yeovil Junction,19182,141084,10208,170474,8140,South West,5838,YVJ
Yeovil Pen Mill,36288,108032,2786,147106,12400,South West,5856,YVP
Yetminster,2340,4472,16,6828,0,South West,5857,YET
Ynyswen,9990,324,3084,13398,0,Wales,3818,YNW
Yoker,45346,78936,13228,137510,0,Scotland,9990,YOK
York,283094,8154150,425734,8862978,930496,Yorkshire and The Humber,8263,YRK
Yorton,4966,1590,736,7292,0,West Midlands,1351,YRT
Ystrad Mynach,157016,7996,33812,198824,0,Wales,4026,YSM
Ystrad Rhondda,32518,1602,6896,41016,0,Wales,3871,YSR
